Index	Cell_type
AAACAGCCAATAGCAA-1	Cardiomyocyte
AAACAGCCAGGCTAAG-1	Cardiomyocyte
AAACAGCCATTAAACC-1	Endothelial_cell
AAACATGCAATCATGT-1	Cardiomyocyte
AAACATGCATAGACCC-1	Cardiomyocyte
AAACCAACAACCTGGT-1	Fibroblast
AAACCGAAGGGCTTTG-1	Pericyte
AAACCGCGTGCCGCAA-1	Fibroblast
AAACGTACATAACGGG-1	Cardiomyocyte
AAAGGAGCAGTTAGCC-1	Cardiomyocyte
AAAGGAGCATATAACC-1	Cardiomyocyte
AAAGGAGCATTGTTGG-1	Cardiomyocyte
AAAGGCTCAGTTATGT-1	Cardiomyocyte
AAAGGCTCATTGTGGC-1	Pericyte
AAAGGTTAGGCGAATA-1	Fibroblast
AACAAGCCAGGTCCTG-1	Cardiomyocyte
AACAGCAAGTAAGTGG-1	Fibroblast
AACAGGATCAGGTCCA-1	Fibroblast
AACATAGCACAAGCCT-1	Fibroblast
AACATAGCACTAAGTT-1	Fibroblast
AACATCATCAAGTGAG-1	Cardiomyocyte
AACATCATCCATCAGG-1	Endothelial_cell
AACCGCTCAAGCTAAA-1	Endothelial_cell
AACCGGCTCCAACTGG-1	Endothelial_cell
AACCGGCTCCCTCATA-1	Cardiomyocyte
AACCTCACAATGAATG-1	Cardiomyocyte
AACCTTAAGACTTATG-1	Fibroblast
AACCTTAAGCAAACCT-1	Cardiomyocyte
AACCTTAAGGTAACGA-1	Fibroblast
AACCTTGCACGAATCC-1	Cardiomyocyte
AACCTTGCACTATGGC-1	Cardiomyocyte
AACCTTGCAGCAAGAT-1	Fibroblast
AACGACAAGTCACTAA-1	Cardiomyocyte
AACGCTAGTTTACTTG-1	Pericyte
AACGGTAAGCGATAAG-1	Fibroblast
AACTCACAGGAGTCTT-1	Fibroblast
AACTCACAGTGACCTG-1	Fibroblast
AACTGTTCACTGACTA-1	Fibroblast
AAGAATCAGTGAACAG-1	Pericyte
AAGACAAGTCCTAAGA-1	Cardiomyocyte
AAGACAAGTGGTTCTT-1	Pericyte
AAGACAAGTTAGGTTG-1	Endothelial_cell
AAGACATAGGACCTGC-1	Cardiomyocyte
AAGACATAGGTTTGCG-1	Cardiomyocyte
AAGCAAGTCACACAGT-1	Cardiomyocyte
AAGCCTCCACCATATG-1	Pericyte
AAGCCTGTCTAAATCG-1	Cardiomyocyte
AAGCCTGTCTATTGTC-1	Cardiomyocyte
AAGCCTTAGAAGCTAG-1	Cardiomyocyte
AAGCGTTTCACAGCCA-1	Cardiomyocyte
AAGCTAGAGAACAAGT-1	Endothelial_cell
AAGCTATGTCAACAAT-1	Endothelial_cell
AAGCTATGTGATGGCT-1	Endothelial_cell
AAGCTTGGTGTTGTAG-1	Fibroblast
AAGGAAGCAGGCTAAG-1	Fibroblast
AAGGATTAGCCACAAT-1	Fibroblast
AAGGATTAGCGGGCAA-1	Cardiomyocyte
AAGGCCCTCCAAATCA-1	Pericyte
AAGGTATAGGCACAGG-1	Fibroblast
AAGGTCAAGCCTCTCG-1	Cardiomyocyte
AAGGTCAAGTCAGGCC-1	Fibroblast
AAGGTGCAGCTAAAGG-1	Cardiomyocyte
AAGGTGCAGTTCCCGT-1	Endothelial_cell
AAGTAGCCAGTTGCGT-1	Cardiomyocyte
AAGTCTATCAGGGCCT-1	Cardiomyocyte
AAGTGCAAGCCTTAAA-1	Cardiomyocyte
AAGTGCAAGCGCCTAA-1	Cardiomyocyte
AAGTGCAAGGCATGAA-1	Cardiomyocyte
AAGTGCAAGGGTTAGA-1	Pericyte
AAGTGCAAGTAGCTTA-1	Endothelial_cell
AAGTGTTGTCAGGCAT-1	Cardiomyocyte
AAGTTACGTGCACGCA-1	Cardiomyocyte
AAGTTACGTTGCACGG-1	Cardiomyocyte
AAGTTAGCAATAACCT-1	Cardiomyocyte
AAGTTAGCAGAATGAC-1	Endothelial_cell
AAGTTTGTCGCTAGCA-1	Endothelial_cell
AATAACCGTGGTTATG-1	Cardiomyocyte
AATAGCTGTACTTAGG-1	Fibroblast
AATATCCCACTTGTTC-1	Cardiomyocyte
AATATCCCATTGTCCT-1	Cardiomyocyte
AATCATCCAATGAGGT-1	Endothelial_cell
AATCATGTCCTCCATA-1	Cardiomyocyte
AATCATGTCTAGCGTG-1	Cardiomyocyte
AATCCATCAAGGATTA-1	Cardiomyocyte
AATCCGTAGCTGGCTA-1	Fibroblast
AATCCGTAGTAGCGCC-1	Fibroblast
AATCCTAAGCTGTCAG-1	Fibroblast
AATCGCCCAATATGGA-1	Cardiomyocyte
AATCGCCCATAATCGT-1	Fibroblast
AATCGCCCATGAATCT-1	Pericyte
AATCTCAAGAACCTGT-1	Endothelial_cell
AATCTCAAGCCTAATA-1	Cardiomyocyte
AATCTCAAGGAGGTTA-1	Endothelial_cell
AATGAAGGTTGTTGTC-1	Endothelial_cell
AATGTCCAGCGCAATT-1	Pericyte
AATGTCCAGGCTGTCA-1	Cardiomyocyte
AATTACCCACAGCCAT-1	Endothelial_cell
AATTAGCGTCATTGTC-1	Pericyte
AATTAGCGTTACCGGG-1	Fibroblast
AATTAGCGTTTGGCTT-1	Cardiomyocyte
AATTAGGCACATTAAC-1	Pericyte
AATTGGACACATAGCC-1	Endothelial_cell
AATTGTGTCATGTCAA-1	Cardiomyocyte
AATTGTGTCCGTCCAT-1	Cardiomyocyte
AATTTGCCAGCTTAGC-1	Endothelial_cell
AATTTGGTCCTACCTA-1	Cardiomyocyte
ACAACACTCCGCCAAA-1	Fibroblast
ACAACACTCTAGCGAT-1	Cardiomyocyte
ACAACATGTTTATCTG-1	Endothelial_cell
ACACAATGTAACCACA-1	Endothelial_cell
ACACCTTGTAGTTAAC-1	Endothelial_cell
ACACCTTGTCAACAAT-1	Endothelial_cell
ACACCTTGTGGCTTCC-1	Cardiomyocyte
ACACTAGGTCTATCGT-1	Fibroblast
ACACTTAAGACAAGTG-1	Fibroblast
ACACTTAAGCATGACT-1	Cardiomyocyte
ACACTTAAGGCAAGTA-1	Cardiomyocyte
ACACTTAAGTTGCGTG-1	Cardiomyocyte
ACACTTGCACAATGCC-1	Cardiomyocyte
ACACTTGCACCCTCAC-1	Cardiomyocyte
ACAGCGCTCACTAAGC-1	Endothelial_cell
ACAGCGCTCCTAGTTT-1	Fibroblast
ACAGGAATCAATCATG-1	Cardiomyocyte
ACAGGAATCACCAATA-1	Cardiomyocyte
ACAGGAATCATGCGTG-1	Endothelial_cell
ACAGGAATCGATAACC-1	Fibroblast
ACAGGTAAGATTGAGG-1	Fibroblast
ACAGGTAAGGTGTCCA-1	Endothelial_cell
ACATAGCTCATGGCTG-1	Endothelial_cell
ACATAGCTCCCGCATT-1	Cardiomyocyte
ACATAGCTCTTGTCTG-1	Fibroblast
ACATCAATCGGGACTC-1	Endothelial_cell
ACATCATCAGCATTAT-1	Pericyte
ACATTAGTCACTTCAT-1	Pericyte
ACATTGCAGTATTGGC-1	Pericyte
ACATTGCAGTTTAACG-1	Cardiomyocyte
ACCAAACTCACTAAGC-1	Cardiomyocyte
ACCAAACTCTTAATGG-1	Cardiomyocyte
ACCAAGCGTTTCAGGA-1	Fibroblast
ACCAAGTTCGAAGTGA-1	Cardiomyocyte
ACCAATATCAATGAGG-1	Fibroblast
ACCACATAGCAAACCT-1	Pericyte
ACCAGCTCAATAACGA-1	Cardiomyocyte
ACCAGCTCAATCGCAC-1	Cardiomyocyte
ACCAGGCTCATCCACC-1	Endothelial_cell
ACCAGGCTCGCTAAGT-1	Cardiomyocyte
ACCATAATCTAATTGG-1	Cardiomyocyte
ACCATTAAGTTCCTCA-1	Endothelial_cell
ACCCAGGGTGGTTCTT-1	Endothelial_cell
ACCCAGGGTTAGCCAA-1	Endothelial_cell
ACCCGGTAGTGCTGTG-1	Endothelial_cell
ACCCGTAAGGTTTACA-1	Endothelial_cell
ACCCTGTTCAGGTTTA-1	Cardiomyocyte
ACCCTGTTCCAGGGAG-1	Cardiomyocyte
ACCCTGTTCGCACAAT-1	Endothelial_cell
ACCCTGTTCTTAGCCC-1	Endothelial_cell
ACCTAAGGTTCATCTA-1	Cardiomyocyte
ACCTCACTCATCCACC-1	Endothelial_cell
ACCTGGTCACCTGGTG-1	Fibroblast
ACCTGTTGTACAAAGA-1	Cardiomyocyte
ACCTTGCTCCAGGTCA-1	Cardiomyocyte
ACCTTGCTCGGCTAGC-1	Fibroblast
ACCTTGCTCTGCAACG-1	Cardiomyocyte
ACCTTGTGTTGCACGG-1	Endothelial_cell
ACCTTGTGTTGTCATC-1	Pericyte
ACGAACAAGCTAATCA-1	Cardiomyocyte
ACGAAGTCAACTAGGG-1	Pericyte
ACGAAGTCACATTAAC-1	Endothelial_cell
ACGAAGTCAGTTTGGC-1	Cardiomyocyte
ACGACAAAGTAAGAAC-1	Cardiomyocyte
ACGACTTAGGCTACAT-1	Cardiomyocyte
ACGACTTAGGTGTTAC-1	Pericyte
ACGAGTAAGTATTGGC-1	Fibroblast
ACGAGTAAGTGAGCAA-1	Fibroblast
ACGATTCAGCTAATCA-1	Pericyte
ACGATTCAGGCTGGCT-1	Endothelial_cell
ACGCAAGCAGAAACGT-1	Fibroblast
ACGCAAGCATAACGGG-1	Cardiomyocyte
ACGCACGGTCGCATAA-1	Pericyte
ACGCACGGTGCAATGC-1	Fibroblast
ACGCCTTTCGATTATG-1	Cardiomyocyte
ACGCTTGAGTAAGGGC-1	Cardiomyocyte
ACGGTTAGTAATGACT-1	Cardiomyocyte
ACGGTTAGTTAATGAC-1	Fibroblast
ACGGTTTAGCACTAAC-1	Fibroblast
ACGTCCAAGGAGTCGG-1	Endothelial_cell
ACGTCCTTCTCGACCT-1	Cardiomyocyte
ACGTTACAGGATCCGC-1	Cardiomyocyte
ACGTTACAGTAGCGCC-1	Endothelial_cell
ACGTTACAGTCTCACC-1	Cardiomyocyte
ACTAAAGCAAGTGTTT-1	Cardiomyocyte
ACTAAAGCACCCACAG-1	Fibroblast
ACTAAAGCAGTACCGT-1	Endothelial_cell
ACTAAAGCATTAGGCC-1	Endothelial_cell
ACTAACTCATAAGCAA-1	Endothelial_cell
ACTATCCGTATGGTGC-1	Endothelial_cell
ACTATCCGTGTCACGG-1	Fibroblast
ACTATGTCACTCAACA-1	Cardiomyocyte
ACTATGTCAGGTATTT-1	Fibroblast
ACTCAGTAGCGGTTAT-1	Pericyte
ACTCAGTAGTAACGAG-1	Cardiomyocyte
ACTCCTCAGCCTCTGT-1	Endothelial_cell
ACTGAAACAGGCCAAA-1	Fibroblast
ACTTACAAGGGTCTAT-1	Cardiomyocyte
ACTTACTTCTTAGCCC-1	Cardiomyocyte
ACTTAGTCACCTCAGG-1	Cardiomyocyte
ACTTAGTCAGGACCAA-1	Cardiomyocyte
ACTTATCTCTTAGTGA-1	Cardiomyocyte
ACTTCGCTCCGTGACA-1	Pericyte
ACTTGCACACCAGGTT-1	Pericyte
ACTTGCACAGAGGCTA-1	Cardiomyocyte
ACTTGTAAGTCATTTC-1	Cardiomyocyte
ACTTTGTTCGGCTATG-1	Cardiomyocyte
AGAAACCCATGCATAT-1	Cardiomyocyte
AGAAACTAGGGACTAA-1	Cardiomyocyte
AGAACAAGTCAAGTGC-1	Fibroblast
AGAACAAGTTAGACCA-1	Cardiomyocyte
AGAACCAAGGCTACAT-1	Cardiomyocyte
AGAAGGTGTACCGTTT-1	Endothelial_cell
AGAATCGAGAACCTAC-1	Endothelial_cell
AGAATCGAGCGCCTAA-1	Fibroblast
AGAATCGAGTTAACCA-1	Fibroblast
AGAATCTGTAGCTGGT-1	Endothelial_cell
AGAATCTGTTACTTGC-1	Cardiomyocyte
AGACACGCATCGTTCT-1	Cardiomyocyte
AGACACGCATGCAACC-1	Pericyte
AGACTATGTAATCACG-1	Cardiomyocyte
AGAGAAGCAAGGTCCT-1	Pericyte
AGAGAGGAGTATTGGC-1	Cardiomyocyte
AGAGATTAGCTTAACA-1	Endothelial_cell
AGAGGAACACCTGCCT-1	Cardiomyocyte
AGAGGAACACGTTACA-1	Pericyte
AGAGGATGTGTGTCCC-1	Cardiomyocyte
AGATGAAGTGATCAGC-1	Endothelial_cell
AGATGAAGTTGTAACG-1	Cardiomyocyte
AGCAAATAGCACGATT-1	Pericyte
AGCAAATAGGCGCTAC-1	Fibroblast
AGCACAGCAAGACTCC-1	Cardiomyocyte
AGCACTTAGACTCGCA-1	Cardiomyocyte
AGCACTTAGAGGATAT-1	Fibroblast
AGCAGGTAGGCGAATA-1	Fibroblast
AGCCAGTGTGATTACG-1	Cardiomyocyte
AGCCTAAGTGGGTACT-1	Cardiomyocyte
AGCCTAAGTTTCGCGC-1	Cardiomyocyte
AGCCTGGGTGTTTGCT-1	Fibroblast
AGCGCTCAGAGAGCCG-1	Endothelial_cell
AGCGCTCAGCTCGCTT-1	Fibroblast
AGCGGACCACAAACTT-1	Pericyte
AGCGGACCACTGACTA-1	Cardiomyocyte
AGCGGACCAGTCTATG-1	Cardiomyocyte
AGCGGATAGGAGCATA-1	Cardiomyocyte
AGCGTGCTCATTAGCA-1	Fibroblast
AGCTAACTCATTACGA-1	Cardiomyocyte
AGCTACGTCAAGCTAC-1	Pericyte
AGCTACTAGAGAGCCG-1	Cardiomyocyte
AGCTCATAGACAAGTG-1	Endothelial_cell
AGCTCATAGGCATTGT-1	Cardiomyocyte
AGCTGCTCAAGGAATC-1	Cardiomyocyte
AGCTTAATCAAACCGT-1	Fibroblast
AGCTTAATCAGCCAAT-1	Cardiomyocyte
AGCTTAATCCCGAACA-1	Cardiomyocyte
AGCTTCCTCGCGACAC-1	Cardiomyocyte
AGCTTTAAGCTATATG-1	Fibroblast
AGGAAACGTACTGATG-1	Cardiomyocyte
AGGAACCAGCAGCTCA-1	Fibroblast
AGGACGTAGTCGCTAG-1	Cardiomyocyte
AGGAGCTAGACACCGC-1	Cardiomyocyte
AGGAGCTAGACTTATG-1	Fibroblast
AGGAGCTAGGACAACA-1	Cardiomyocyte
AGGAGCTAGGGTCCAC-1	Cardiomyocyte
AGGATATAGTTTGGTA-1	Fibroblast
AGGATCCGTTTCCTCC-1	Cardiomyocyte
AGGATTGAGGCGAAAC-1	Fibroblast
AGGATTGAGGTCCACA-1	Cardiomyocyte
AGGCAATCATGAGTTT-1	Cardiomyocyte
AGGCTAAAGTTATTCC-1	Cardiomyocyte
AGGGCCTTCAGCAAAG-1	Fibroblast
AGGGCCTTCCGCCTCA-1	Endothelial_cell
AGGGCCTTCTCCATGC-1	Cardiomyocyte
AGGGCTACATCATGGC-1	Cardiomyocyte
AGGGTTGCACACAATT-1	Cardiomyocyte
AGGTACGCAACCTGGT-1	Fibroblast
AGGTCAAAGCCTGACA-1	Cardiomyocyte
AGGTCAAAGTCATCCC-1	Cardiomyocyte
AGGTCAAAGTTTCCGC-1	Endothelial_cell
AGGTCCGGTTAGAGGG-1	Cardiomyocyte
AGGTCTTAGGTTAGCT-1	Fibroblast
AGGTGAATCATTATGG-1	Cardiomyocyte
AGGTGAGGTTTGCTGT-1	Endothelial_cell
AGGTTAACATGCATAT-1	Cardiomyocyte
AGGTTACTCCCATAAA-1	Cardiomyocyte
AGGTTGCGTTCACTGT-1	Cardiomyocyte
AGGTTGCGTTTAGTCC-1	Fibroblast
AGGTTTGGTTTAACCC-1	Cardiomyocyte
AGTAAACAGCGAGCGA-1	Fibroblast
AGTAAACAGCTCGCTT-1	Fibroblast
AGTAACACAACACTTG-1	Cardiomyocyte
AGTAACACACCTGGTG-1	Endothelial_cell
AGTAACACATCCAGGT-1	Fibroblast
AGTAACCTCATTATGG-1	Pericyte
AGTAACCTCGCATCCT-1	Pericyte
AGTAACCTCGTTACTT-1	Endothelial_cell
AGTAAGTAGCTAAGTC-1	Cardiomyocyte
AGTAAGTAGTAGGCGG-1	Cardiomyocyte
AGTAATGCAAGGACCA-1	Cardiomyocyte
AGTATAGCAAACTAAG-1	Cardiomyocyte
AGTATAGCACCTAAGC-1	Cardiomyocyte
AGTCAAGAGACTTATG-1	Cardiomyocyte
AGTCAAGAGCGGCTGT-1	Endothelial_cell
AGTCAAGAGTAAGTGG-1	Cardiomyocyte
AGTCAATGTGTGTGGT-1	Endothelial_cell
AGTCAATGTTCCTGTG-1	Endothelial_cell
AGTCCTGAGTTATGTG-1	Pericyte
AGTCCTGAGTTGCGTG-1	Cardiomyocyte
AGTCCTTGTTAGGACC-1	Endothelial_cell
AGTCGCATCGTTATAG-1	Endothelial_cell
AGTCGCATCTTGCAGG-1	Cardiomyocyte
AGTCTTGCAAGGACCA-1	Cardiomyocyte
AGTCTTGCAATTAACC-1	Cardiomyocyte
AGTCTTGCAGCATGTC-1	Fibroblast
AGTGAGTCAAATTCGT-1	Cardiomyocyte
AGTGAGTCAATAATGG-1	Cardiomyocyte
AGTGATGAGGAAGCAC-1	Endothelial_cell
AGTGCACGTAAGTCGC-1	Fibroblast
AGTGCACGTGCTGTAA-1	Cardiomyocyte
AGTGCACGTTGGTTAG-1	Fibroblast
AGTGCCGGTCCGTGAG-1	Pericyte
AGTGCCGGTTTGGGCG-1	Endothelial_cell
AGTGGACAGGAGTCGG-1	Fibroblast
AGTTACATCATGGCCA-1	Fibroblast
AGTTACTCAACCCTAA-1	Cardiomyocyte
AGTTACTCAAGGTAAC-1	Cardiomyocyte
AGTTGCAGTCAATACG-1	Cardiomyocyte
AGTTGCAGTGCTCCGT-1	Endothelial_cell
AGTTGCAGTTGGCGTG-1	Pericyte
AGTTGGCGTGCACGCA-1	Fibroblast
AGTTTGATCACTAGGT-1	Cardiomyocyte
AGTTTGCAGCTAAAGG-1	Cardiomyocyte
AGTTTGCAGCTATGAC-1	Endothelial_cell
ATAACGACACAACAGG-1	Fibroblast
ATAAGTCGTTCGGTAA-1	Endothelial_cell
ATACCTGCATAGACTT-1	Cardiomyocyte
ATAGCATGTTGCGCGA-1	Fibroblast
ATATGCATCAGCTAAC-1	Cardiomyocyte
ATATGCATCCTCAGCT-1	Endothelial_cell
ATCAAGACAGTTAGCC-1	Endothelial_cell
ATCAATCCACAACAGG-1	Endothelial_cell
ATCACAATCGTTTCGC-1	Endothelial_cell
ATCACCCTCATGCTCC-1	Endothelial_cell
ATCACCCTCCAAATCA-1	Cardiomyocyte
ATCACCCTCCCTTGCG-1	Endothelial_cell
ATCACTAAGGGACTAA-1	Cardiomyocyte
ATCACTAAGGTCCAAT-1	Cardiomyocyte
ATCAGGTTCCCTGTTA-1	Fibroblast
ATCAGGTTCCGGAACC-1	Fibroblast
ATCAGGTTCTCATCAT-1	Fibroblast
ATCATCAAGCACTAAC-1	Endothelial_cell
ATCATCAAGGAGGGTT-1	Endothelial_cell
ATCATCAAGTGAACGA-1	Endothelial_cell
ATCCACCTCTCCATGC-1	Pericyte
ATCCATAAGCTTTGTT-1	Endothelial_cell
ATCCATAAGGATCCGC-1	Fibroblast
ATCCATAAGGTGAAAT-1	Fibroblast
ATCCCGCGTTGGATAT-1	Cardiomyocyte
ATCCGTGAGGGATGCG-1	Endothelial_cell
ATCCTCATCCCGTTAC-1	Cardiomyocyte
ATCCTCATCTAATCCT-1	Cardiomyocyte
ATCCTGACAAGGGTTG-1	Fibroblast
ATCCTGACATAAACCT-1	Cardiomyocyte
ATCGAGGCACTTCATC-1	Cardiomyocyte
ATCGAGGCATATAACC-1	Cardiomyocyte
ATCGCCCGTAACCACA-1	Pericyte
ATCGGCCAGCTTACTT-1	Cardiomyocyte
ATGAAGCCACGAACAG-1	Endothelial_cell
ATGAAGTAGGATCCGC-1	Pericyte
ATGAAGTAGGCCCAGT-1	Cardiomyocyte
ATGAAGTAGGCCTAAT-1	Fibroblast
ATGAAGTAGGTTACGT-1	Fibroblast
ATGAATGCAAACCTAT-1	Fibroblast
ATGAATGCAACCCTAA-1	Endothelial_cell
ATGAATGCACCTACGG-1	Cardiomyocyte
ATGAATGCACGGTACT-1	Fibroblast
ATGACAACAGTAAAGC-1	Cardiomyocyte
ATGACTCAGCAAGGGT-1	Pericyte
ATGACTCAGGTCCAAT-1	Fibroblast
ATGATGGAGCAGGCCT-1	Cardiomyocyte
ATGCAAACAGCCAGTT-1	Fibroblast
ATGCAAACATCTTGAG-1	Fibroblast
ATGCAGGCAGGCATGA-1	Endothelial_cell
ATGCATTCAGATAGAC-1	Fibroblast
ATGCCTGAGACAGGCG-1	Pericyte
ATGCGATTCCAAATCA-1	Endothelial_cell
ATGCGATTCGATTTAG-1	Cardiomyocyte
ATGCTTAAGGCTGGCT-1	Cardiomyocyte
ATGGACAAGGATTGAG-1	Endothelial_cell
ATGGACAAGGCGTAAA-1	Cardiomyocyte
ATGGCCCAGTAGCTTA-1	Cardiomyocyte
ATGGCCGGTCCAAGAC-1	Endothelial_cell
ATGTAACGTAAGCTTG-1	Cardiomyocyte
ATGTAACGTTACATCC-1	Endothelial_cell
ATGTCATCAGGCATCT-1	Cardiomyocyte
ATGTCATCAGTAAAGC-1	Fibroblast
ATGTGAGAGGTTTACA-1	Fibroblast
ATGTTCAAGGTACCGC-1	Fibroblast
ATGTTGTCATGGCCTG-1	Pericyte
ATTAACCCATAAGTCT-1	Fibroblast
ATTACCCGTAACCTAG-1	Fibroblast
ATTACCGCACGTAAGG-1	Cardiomyocyte
ATTACGTCAAACCTAT-1	Fibroblast
ATTACGTCACAATTAC-1	Cardiomyocyte
ATTACTGAGGACACTT-1	Cardiomyocyte
ATTACTGAGTCATCCC-1	Cardiomyocyte
ATTAGGTGTGTTTGAG-1	Fibroblast
ATTATCCTCAATGTGC-1	Cardiomyocyte
ATTATCCTCGATATTG-1	Endothelial_cell
ATTATCCTCTCACATT-1	Endothelial_cell
ATTCACTTCTCACAAA-1	Cardiomyocyte
ATTCCGGAGCGAAGTA-1	Cardiomyocyte
ATTCCTCCAAAGGCCA-1	Cardiomyocyte
ATTCCTCCAGCTTACA-1	Endothelial_cell
ATTCGTTTCCGGAACC-1	Fibroblast
ATTCGTTTCTAGCTAA-1	Endothelial_cell
ATTGAAGCACAATACT-1	Endothelial_cell
ATTGAAGCACAGGATG-1	Pericyte
ATTGACTCAAACGGGC-1	Cardiomyocyte
ATTGACTCAATTGAGA-1	Pericyte
ATTGACTCACCTCAGG-1	Fibroblast
ATTGACTCAGAGGCTA-1	Pericyte
ATTGACTCAGGAACCA-1	Cardiomyocyte
ATTGACTCATGCATAT-1	Cardiomyocyte
ATTGCAGGTGCTAGCG-1	Cardiomyocyte
ATTGCGCCATATAACC-1	Pericyte
ATTGCTCGTGAATCGC-1	Cardiomyocyte
ATTGGCTAGTGAGGGT-1	Cardiomyocyte
ATTGTGATCCGCCTCA-1	Cardiomyocyte
ATTTAGCCAGCTTAGC-1	Pericyte
ATTTGCGCAAGCGAGC-1	Cardiomyocyte
ATTTGCGCAATCCCTT-1	Fibroblast
ATTTGCGCACGGTTTA-1	Endothelial_cell
ATTTGTGAGCGGATAA-1	Cardiomyocyte
CAAACAACAAATGCCC-1	Cardiomyocyte
CAAACAACACAAACTT-1	Fibroblast
CAAACAACATATAACC-1	Cardiomyocyte
CAAACACTCGATTATG-1	Cardiomyocyte
CAAACACTCTTTAAGG-1	Fibroblast
CAAACATGTGTGAGGA-1	Endothelial_cell
CAAACATGTTGTGATG-1	Cardiomyocyte
CAAACCGTCAAGGACA-1	Pericyte
CAAACCGTCATGCGTG-1	Fibroblast
CAAACCGTCGCTTGCT-1	Cardiomyocyte
CAAACTGGTTCACTGT-1	Cardiomyocyte
CAAAGCGCACAAACTT-1	Fibroblast
CAAAGCGCATAGACCC-1	Endothelial_cell
CAAAGGATCTTGCTAT-1	Cardiomyocyte
CAAAGTGAGCACAGCC-1	Cardiomyocyte
CAAAGTGAGTATTGCA-1	Pericyte
CAAAGTGAGTTAGGCT-1	Cardiomyocyte
CAACAATGTGTTTGTC-1	Fibroblast
CAACAGGCAGAGGCTA-1	Endothelial_cell
CAACAGGCATGCAACC-1	Cardiomyocyte
CAACCCTTCAAACCTA-1	Fibroblast
CAACCCTTCGATAACC-1	Fibroblast
CAAGACAAGTTATCTC-1	Endothelial_cell
CAAGACAAGTTCCCAC-1	Cardiomyocyte
CAAGCTAGTAATAGCT-1	Cardiomyocyte
CAAGCTAGTCCCGGAA-1	Endothelial_cell
CAAGGCCTCCCGTTAC-1	Cardiomyocyte
CAAGGTTTCTCCATAT-1	Pericyte
CAAGTAACAATTTAGC-1	Fibroblast
CAAGTAACATAAGTTC-1	Cardiomyocyte
CAAGTAACATGTGGGA-1	Cardiomyocyte
CAAGTTATCCTAAATG-1	Endothelial_cell
CAATAAGCATGAATCT-1	Cardiomyocyte
CAATATGTCTACCTGC-1	Cardiomyocyte
CAATATGTCTTCAATC-1	Cardiomyocyte
CAATCCCTCCAACTGG-1	Fibroblast
CAATCGCCAGAGGCTA-1	Fibroblast
CAATCGCCAGCTCATA-1	Endothelial_cell
CAATCTAAGGTCCAAT-1	Fibroblast
CAATGAACAACTAGAA-1	Endothelial_cell
CAATGAACAGCTACGT-1	Cardiomyocyte
CAATGACTCGATTATG-1	Fibroblast
CAATGACTCTTTAAGG-1	Fibroblast
CAATGTCAGTGTTGCG-1	Cardiomyocyte
CACAGGCTCAATGTGC-1	Cardiomyocyte
CACAGGGAGTCTCACC-1	Pericyte
CACATACAGTCCTGAG-1	Fibroblast
CACATACAGTTATTCC-1	Pericyte
CACCGGTAGTGATTCA-1	Fibroblast
CACCTCAGTCACACCC-1	Pericyte
CACCTCAGTCCGTGAG-1	Endothelial_cell
CACCTCAGTTATCGAG-1	Endothelial_cell
CACCTCAGTTCCAGGG-1	Endothelial_cell
CACCTGTTCTAACCAA-1	Fibroblast
CACCTGTTCTATTGTC-1	Fibroblast
CACCTGTTCTTGTCTG-1	Cardiomyocyte
CACTAGCCACGTAATT-1	Cardiomyocyte
CACTAGCCAGAAACGT-1	Pericyte
CACTAGCCATGTTGCA-1	Cardiomyocyte
CACTGACCAACGTGCT-1	Fibroblast
CACTGACCAATAACCT-1	Cardiomyocyte
CACTGACCAATTAACC-1	Cardiomyocyte
CACTTAAAGGTAACGA-1	Cardiomyocyte
CACTTTGTCAACCAAC-1	Cardiomyocyte
CACTTTGTCACCTGCT-1	Cardiomyocyte
CACTTTGTCATAGACC-1	Cardiomyocyte
CAGAACCGTCAGGCAT-1	Endothelial_cell
CAGAACCGTTGAAGCC-1	Cardiomyocyte
CAGAATCTCCGCTAGA-1	Endothelial_cell
CAGCATGTCATGGTTA-1	Fibroblast
CAGCATGTCCCTCATA-1	Endothelial_cell
CAGCATGTCTTTAGGA-1	Cardiomyocyte
CAGCCAATCATGGTTA-1	Cardiomyocyte
CAGCCAATCCTTGAGG-1	Fibroblast
CAGCTAAGTGTTGTGA-1	Cardiomyocyte
CAGCTATAGCAGGTGG-1	Endothelial_cell
CAGCTATAGGGTTAGA-1	Cardiomyocyte
CAGCTCAAGCTGCACA-1	Fibroblast
CAGCTCAAGTAAGTGG-1	Cardiomyocyte
CAGGAAGGTGTGCAAC-1	Fibroblast
CAGGAAGGTGTTTGTC-1	Cardiomyocyte
CAGGACACACTCAACA-1	Pericyte
CAGGACCTCATGTGGT-1	Endothelial_cell
CAGGATGCAGGCATGA-1	Fibroblast
CAGGCTATCCCTCATA-1	Cardiomyocyte
CAGGCTATCGGTTTCC-1	Cardiomyocyte
CAGGTCCAGCAAGACA-1	Cardiomyocyte
CAGGTCCAGCATTATG-1	Endothelial_cell
CAGGTCCAGCGCCTTT-1	Cardiomyocyte
CAGGTCCAGTAAGGGC-1	Fibroblast
CAGGTGGAGCGCTCAA-1	Pericyte
CAGGTGGAGGATGATG-1	Cardiomyocyte
CAGTACCCACAGAACG-1	Endothelial_cell
CAGTATGGTGTAACCA-1	Endothelial_cell
CATAGACTCAGGAAGC-1	Cardiomyocyte
CATAGACTCCTCGATC-1	Cardiomyocyte
CATAGCTAGTAACGAG-1	Cardiomyocyte
CATAGGCGTAGCTGCG-1	Pericyte
CATAGTCAGCAGGTTT-1	Cardiomyocyte
CATAGTCAGCATTAGC-1	Endothelial_cell
CATAGTCAGGAGGGTT-1	Endothelial_cell
CATCAATCAACTGGCT-1	Cardiomyocyte
CATCAGCCAGCCAGAA-1	Cardiomyocyte
CATCATAAGACTTATG-1	Fibroblast
CATCATAAGAGGAGGA-1	Endothelial_cell
CATCCCAGTACTTAGG-1	Cardiomyocyte
CATCCTCAGCTAAAGG-1	Endothelial_cell
CATCCTCAGCTGAGGG-1	Cardiomyocyte
CATCCTCAGGCCTGGT-1	Cardiomyocyte
CATCCTCAGGTCCGTA-1	Cardiomyocyte
CATCCTCAGGTTAGCT-1	Fibroblast
CATGAGGCACGAATCC-1	Cardiomyocyte
CATGAGGCAGTAGGTG-1	Cardiomyocyte
CATGCAAGTGTTTGCT-1	Endothelial_cell
CATGCAAGTTTATCGC-1	Fibroblast
CATGCATAGTCAGTAC-1	Cardiomyocyte
CATGGATTCTCGACCT-1	Endothelial_cell
CATTATCTCCGGGACT-1	Cardiomyocyte
CATTATCTCTTTGTAC-1	Cardiomyocyte
CATTATGAGCTAATCA-1	Cardiomyocyte
CATTCATTCTCCTCTT-1	Endothelial_cell
CATTCCTCACCTGCTC-1	Endothelial_cell
CATTGTAAGCCTTAAA-1	Endothelial_cell
CATTTGTTCATAGCCG-1	Cardiomyocyte
CATTTGTTCCTGGTGA-1	Endothelial_cell
CATTTGTTCTGTAATG-1	Fibroblast
CCAAACTAGACTTACA-1	Cardiomyocyte
CCAAACTAGAGGAGGA-1	Cardiomyocyte
CCAAACTAGGAGGCAT-1	Cardiomyocyte
CCAAACTAGGTAGCTT-1	Pericyte
CCAACCCGTGATTTGG-1	Cardiomyocyte
CCAAGGCTCGCATTAA-1	Cardiomyocyte
CCAATATCATGGCCTG-1	Cardiomyocyte
CCACACAAGCTAAGTC-1	Cardiomyocyte
CCACACAAGCTGTAAC-1	Endothelial_cell
CCACACAAGTTAGCCG-1	Pericyte
CCACAGGGTAGACAAA-1	Fibroblast
CCACAGGGTTAACAGT-1	Cardiomyocyte
CCACAGGGTTCGCTTG-1	Cardiomyocyte
CCACTTGGTTAGTGAT-1	Endothelial_cell
CCAGCCTGTTCGCGCT-1	Endothelial_cell
CCAGCTGCAAGCGATG-1	Endothelial_cell
CCAGGAACATATTGAC-1	Endothelial_cell
CCAGGATGTGTTTGTC-1	Cardiomyocyte
CCATAAATCACAGGAA-1	Cardiomyocyte
CCATCATGTGACATAT-1	Cardiomyocyte
CCATTGTGTGCACGCA-1	Cardiomyocyte
CCCAACCGTCAGTAAT-1	Cardiomyocyte
CCCAACCGTCGACTAA-1	Endothelial_cell
CCCAATTGTTTCGCGC-1	Cardiomyocyte
CCCAGTTTCCTAAGAC-1	Fibroblast
CCCAGTTTCGAGGAAC-1	Fibroblast
CCCAGTTTCTTAATGG-1	Fibroblast
CCCGCAACAGCCTAAC-1	Cardiomyocyte
CCCGCTTCAATATACC-1	Cardiomyocyte
CCCGTAAAGGAAGCAC-1	Endothelial_cell
CCCTCAGTCATTTGCT-1	Cardiomyocyte
CCCTCAGTCTGTTCAT-1	Cardiomyocyte
CCCTCATAGCGATAAG-1	Endothelial_cell
CCCTCATAGGAGCATA-1	Cardiomyocyte
CCCTCATAGGCCCAGT-1	Fibroblast
CCCTCATAGGTGTTAC-1	Fibroblast
CCCTGTTAGGCGCTTA-1	Pericyte
CCCTGTTAGTTAGCCG-1	Cardiomyocyte
CCCTTAATCAGGATGA-1	Endothelial_cell
CCCTTAATCATCACTT-1	Cardiomyocyte
CCCTTAATCCGGTTGA-1	Cardiomyocyte
CCGATGCAGCCGCAGT-1	Endothelial_cell
CCGATGCAGGGTGGAT-1	Endothelial_cell
CCGATGCAGTTCCTCA-1	Cardiomyocyte
CCGCAAATCTCAATAG-1	Endothelial_cell
CCGCCAACATGAGTTT-1	Cardiomyocyte
CCGCTAAAGCAGGTGG-1	Endothelial_cell
CCGCTAAAGGCGAAAC-1	Cardiomyocyte
CCGCTAGCAGCAACCT-1	Cardiomyocyte
CCGTGCTGTCATGCCC-1	Endothelial_cell
CCGTTAACACATTAAC-1	Endothelial_cell
CCGTTACTCAGGTCCA-1	Fibroblast
CCGTTATGTCATTAGG-1	Fibroblast
CCGTTGCGTAGGTGTC-1	Fibroblast
CCGTTGCGTTTCGCGC-1	Fibroblast
CCTAAAGGTGCGCAAT-1	Cardiomyocyte
CCTAAATCAAGTGTTT-1	Fibroblast
CCTAAATCACTGACCG-1	Cardiomyocyte
CCTAATAAGTCAATCA-1	Endothelial_cell
CCTACTGGTCCCGGAA-1	Cardiomyocyte
CCTACTTCACGAACAG-1	Cardiomyocyte
CCTAGTTGTTGGATAT-1	Cardiomyocyte
CCTAGTTGTTTGCGCC-1	Cardiomyocyte
CCTATAGCAAACGCGA-1	Cardiomyocyte
CCTATATTCAGGATGA-1	Cardiomyocyte
CCTATATTCTCCATAT-1	Cardiomyocyte
CCTATTTAGACAACGA-1	Endothelial_cell
CCTATTTAGCACCACA-1	Cardiomyocyte
CCTCCTCTCCTGCGAA-1	Cardiomyocyte
CCTGAATAGAGAGGCT-1	Cardiomyocyte
CCTGAGTCACCCTCAC-1	Endothelial_cell
CCTGATGAGCGCCTAA-1	Fibroblast
CCTGGATCACCTGCTC-1	Fibroblast
CCTGTATGTTAAGGCC-1	Fibroblast
CCTGTTGGTCTCAGCC-1	Endothelial_cell
CCTTAACGTGAGCAAG-1	Endothelial_cell
CCTTATGTCCCTCACG-1	Endothelial_cell
CCTTATGTCTAGCTAA-1	Endothelial_cell
CCTTATGTCTGGTCCT-1	Cardiomyocyte
CCTTCGTAGACTTATG-1	Endothelial_cell
CCTTCGTAGTAACGGA-1	Cardiomyocyte
CCTTGCGTCACCATTT-1	Pericyte
CCTTGCGTCAGGTTTA-1	Cardiomyocyte
CCTTGCGTCCTAATTC-1	Cardiomyocyte
CCTTGTTCAACTAGAA-1	Endothelial_cell
CCTTGTTCAATTGAGA-1	Fibroblast
CCTTGTTCATCTTGAG-1	Cardiomyocyte
CCTTTAGTCCCAGTAG-1	Pericyte
CCTTTAGTCGCTAAAC-1	Cardiomyocyte
CGAACAAAGTTCCTGC-1	Cardiomyocyte
CGAACCGGTCACGAAC-1	Cardiomyocyte
CGAAGAATCCGGCTAA-1	Pericyte
CGAAGAATCTTTAAGG-1	Cardiomyocyte
CGAAGGCCATAGCTGC-1	Endothelial_cell
CGAATATGTGGGTACT-1	Endothelial_cell
CGAATCTAGCACAGAA-1	Fibroblast
CGACCTGCAAGGTGCA-1	Cardiomyocyte
CGACCTGCATTAGGCC-1	Cardiomyocyte
CGAGCTGGTATTGCAG-1	Cardiomyocyte
CGAGGAAGTTCAAGCA-1	Endothelial_cell
CGAGGTGAGCCTGTTC-1	Cardiomyocyte
CGAGGTGAGTGAGCAA-1	Fibroblast
CGATATTCAAGGCCAA-1	Endothelial_cell
CGATATTCATTGACAT-1	Pericyte
CGATCCTTCCATTACT-1	Cardiomyocyte
CGATCCTTCCGTGACA-1	Cardiomyocyte
CGATCCTTCTCAATTC-1	Cardiomyocyte
CGATTCCTCCTCAGCT-1	Pericyte
CGCAATAGTTGCGCGA-1	Fibroblast
CGCAATCCACTAAATC-1	Endothelial_cell
CGCAATGTCCCGTTGT-1	Endothelial_cell
CGCAATTAGGATTGCT-1	Cardiomyocyte
CGCACAATCACTTCAT-1	Cardiomyocyte
CGCACAATCCTTCTAG-1	Fibroblast
CGCACAATCTAAGTCA-1	Cardiomyocyte
CGCATGATCATTAGCA-1	Cardiomyocyte
CGCATTACAAGGACCA-1	Fibroblast
CGCATTACACCTGGTG-1	Cardiomyocyte
CGCATTACATGAATCT-1	Endothelial_cell
CGCATTTGTGCACGCA-1	Endothelial_cell
CGCATTTGTGCTGGTG-1	Endothelial_cell
CGCGGATTCCCGCATT-1	Cardiomyocyte
CGCGGATTCCCGTTGT-1	Fibroblast
CGCGGATTCCGGTTAG-1	Endothelial_cell
CGCTAATAGCTCCTAC-1	Fibroblast
CGCTACTTCAGGCCTA-1	Cardiomyocyte
CGCTCAGCACAGCCTG-1	Fibroblast
CGCTCCATCAATTACG-1	Endothelial_cell
CGCTCCATCACCAATA-1	Fibroblast
CGCTCCATCAGGATGA-1	Endothelial_cell
CGCTCCATCTAACCAA-1	Pericyte
CGCTGTGCATGAATAG-1	Fibroblast
CGCTTACTCATTGACA-1	Fibroblast
CGGACAACAACTAACT-1	Cardiomyocyte
CGGACAACACACTAAT-1	Cardiomyocyte
CGGACAACAGGGAGGA-1	Pericyte
CGGAGTCTCGGCCAGT-1	Pericyte
CGGAGTCTCTTAGCCC-1	Cardiomyocyte
CGGATAAAGTAGGCGG-1	Cardiomyocyte
CGGATTAGTCCTTAGT-1	Endothelial_cell
CGGATTAGTTTCCTCC-1	Endothelial_cell
CGGCAATGTGTGTCCC-1	Fibroblast
CGGCAATGTTAGAGGG-1	Fibroblast
CGGCAATGTTTCCTCC-1	Cardiomyocyte
CGGCCATAGGCAAGTA-1	Cardiomyocyte
CGGCTCACACTCAACA-1	Endothelial_cell
CGGCTCACAGCAAGGC-1	Cardiomyocyte
CGGCTCACATGCATAT-1	Fibroblast
CGGGACAAGCGCCTAA-1	Fibroblast
CGGGACAAGCTATTAG-1	Cardiomyocyte
CGGTAACGTAAAGCGG-1	Endothelial_cell
CGGTAACGTAGGATTT-1	Cardiomyocyte
CGGTGAACAGTATGTT-1	Cardiomyocyte
CGGTTATAGCTAAGTC-1	Endothelial_cell
CGGTTCCGTGATTTGG-1	Endothelial_cell
CGGTTTCTCAGGGCCT-1	Fibroblast
CGTAACTAGTTGTCAA-1	Endothelial_cell
CGTAATGGTGATTACG-1	Endothelial_cell
CGTAGCGGTTGAGGTC-1	Fibroblast
CGTAGTTAGGAACGCG-1	Cardiomyocyte
CGTAGTTAGGGACCTC-1	Cardiomyocyte
CGTATTGCAAGCCAGA-1	Fibroblast
CGTATTGCAGGTTCAC-1	Pericyte
CGTCAATAGCTAAGTC-1	Endothelial_cell
CGTCATTGTCCAAGAC-1	Fibroblast
CGTCATTGTGAGGTGA-1	Cardiomyocyte
CGTCATTGTGCGCAAT-1	Cardiomyocyte
CGTGACATCACCAATA-1	Pericyte
CGTGACATCATTATGG-1	Cardiomyocyte
CGTGAGGAGGTTAGAG-1	Fibroblast
CGTGAGGAGTAGCGGG-1	Cardiomyocyte
CGTGCACAGTCACTAA-1	Fibroblast
CGTGTGTCAATTAACC-1	Endothelial_cell
CGTGTGTCATAAGTCT-1	Fibroblast
CGTGTTACATAAGTCT-1	Cardiomyocyte
CGTTAAATCATGCTAA-1	Pericyte
CGTTAAATCTCAATGA-1	Endothelial_cell
CGTTAACAGTCATGCG-1	Endothelial_cell
CGTTAGGTCAAGCGCC-1	Cardiomyocyte
CGTTAGTAGCCTCTGT-1	Fibroblast
CGTTAGTAGTTGGGCC-1	Fibroblast
CGTTATCGTGAAGCCT-1	Cardiomyocyte
CGTTATTTCTTAGTCT-1	Cardiomyocyte
CGTTGCAAGGTCAAAG-1	Pericyte
CGTTTGGAGACTATTG-1	Cardiomyocyte
CTAAAGCTCATTGTCT-1	Endothelial_cell
CTAAATGTCGATATTG-1	Pericyte
CTAAATGTCTTGAGCG-1	Cardiomyocyte
CTAACCACACCTGCTC-1	Fibroblast
CTAACCCTCTAATCCT-1	Cardiomyocyte
CTAACCTGTCACGGAT-1	Endothelial_cell
CTAACCTGTCCTTAGT-1	Fibroblast
CTAAGGTTCAATGTGC-1	Cardiomyocyte
CTAAGTCAGTCACTAA-1	Cardiomyocyte
CTAATAGTCGCTAGTG-1	Cardiomyocyte
CTAATCCGTAATTAGC-1	Cardiomyocyte
CTAATCCGTTGGTGAC-1	Endothelial_cell
CTAATCCGTTTCCGGC-1	Pericyte
CTAATCGCAAGGTACG-1	Cardiomyocyte
CTAATGTCAGGCTAGA-1	Cardiomyocyte
CTAATTGAGCTCATAA-1	Fibroblast
CTACTAAAGCGAGTAA-1	Endothelial_cell
CTACTAAAGGTTAGAG-1	Endothelial_cell
CTACTAAAGTTTGCGG-1	Pericyte
CTACTTAGTTCCTGTG-1	Cardiomyocyte
CTAGCTGAGGACTTAC-1	Fibroblast
CTAGGACGTGATGATT-1	Endothelial_cell
CTAGGCGGTAGTAAGA-1	Cardiomyocyte
CTAGGCGGTGTCACGG-1	Endothelial_cell
CTAGGCGGTTATTGCC-1	Cardiomyocyte
CTAGTAATCATGCTCC-1	Cardiomyocyte
CTATAACCAGAAACGT-1	Endothelial_cell
CTATGAGGTGATGAAA-1	Cardiomyocyte
CTATGATCACTAAGAA-1	Pericyte
CTATGTTTCCATCAGG-1	Fibroblast
CTATGTTTCTTGACCC-1	Cardiomyocyte
CTATTACTCCCGTTTA-1	Cardiomyocyte
CTATTACTCGTTAGCG-1	Endothelial_cell
CTCAATAAGACACTTA-1	Cardiomyocyte
CTCAATAAGCTTAGTA-1	Pericyte
CTCACTCAGACACTTA-1	Fibroblast
CTCACTCAGCGGCTGT-1	Endothelial_cell
CTCAGGATCATGCGTG-1	Cardiomyocyte
CTCATCATCCCGCCTA-1	Fibroblast
CTCATCATCGATTTAG-1	Cardiomyocyte
CTCCAAACAACATAAG-1	Cardiomyocyte
CTCCAACTCCAAGTGT-1	Pericyte
CTCCCTGAGTAACGGA-1	Cardiomyocyte
CTCCGGACAACTGGGA-1	Cardiomyocyte
CTCCGGACAAGCGAGC-1	Fibroblast
CTCCGTCCACCTATAG-1	Cardiomyocyte
CTCCGTCCAGGGAGGA-1	Cardiomyocyte
CTCCTAATCTTCAATC-1	Endothelial_cell
CTCCTCACAGAACCGA-1	Pericyte
CTCCTCACAGTTATCG-1	Cardiomyocyte
CTCCTGAGTGCTCACC-1	Cardiomyocyte
CTCGACAAGGGATGCG-1	Endothelial_cell
CTCGACAAGGGCCATC-1	Endothelial_cell
CTCGCTCCACCTCAGG-1	Pericyte
CTCGCTCCATTCCTCG-1	Cardiomyocyte
CTCTAGCTCACAGCCA-1	Cardiomyocyte
CTCTAGCTCCACCCTG-1	Cardiomyocyte
CTCTAGCTCCTCCATA-1	Endothelial_cell
CTCTATGTCCGCACAA-1	Endothelial_cell
CTCTATGTCGTAACGT-1	Fibroblast
CTCTATGTCTCACATT-1	Endothelial_cell
CTCTCACAGCGATAGA-1	Cardiomyocyte
CTCTCACAGGACAATG-1	Cardiomyocyte
CTCTCACAGTCCTTCA-1	Fibroblast
CTCTTGATCAAGCGCC-1	Cardiomyocyte
CTCTTGATCACCATTT-1	Cardiomyocyte
CTCTTGATCATTATGG-1	Cardiomyocyte
CTCTTGATCGCAAACT-1	Cardiomyocyte
CTGAAACTCAACAAGG-1	Cardiomyocyte
CTGACATAGGTAACGA-1	Cardiomyocyte
CTGACCAAGTCCTTCA-1	Pericyte
CTGACCAAGTTATTCC-1	Endothelial_cell
CTGATCACAGGTATTT-1	Endothelial_cell
CTGCAATAGGGCCACT-1	Cardiomyocyte
CTGCTACTCCGCCAAA-1	Cardiomyocyte
CTGCTCCCAAGGAATC-1	Fibroblast
CTGCTCCCAATGCCTA-1	Fibroblast
CTGCTCCCAGGCTTGT-1	Cardiomyocyte
CTGCTCCCATAAACCT-1	Cardiomyocyte
CTGGATGTCGGTAACT-1	Endothelial_cell
CTGGCTAAGCTTCCCG-1	Endothelial_cell
CTGGTAAGTTACCGGG-1	Cardiomyocyte
CTGGTAAGTTGGTTCT-1	Cardiomyocyte
CTGGTCAAGCCTGAGC-1	Endothelial_cell
CTGGTTACAACTGGCT-1	Fibroblast
CTGTAACAGCGCCTAA-1	Endothelial_cell
CTGTAACAGTAGCGCC-1	Endothelial_cell
CTGTACCTCACGCGGT-1	Pericyte
CTGTGTGAGACTTACA-1	Pericyte
CTGTTCATCAAAGGCA-1	Cardiomyocyte
CTGTTCATCCAAGTTA-1	Cardiomyocyte
CTGTTGGAGGAGGTTA-1	Fibroblast
CTGTTTAGTGCTGTAA-1	Cardiomyocyte
CTTAAGATCGAGGAAC-1	Fibroblast
CTTAAGATCGCTATAA-1	Cardiomyocyte
CTTAAGGGTTGTCATC-1	Cardiomyocyte
CTTAAGGGTTTAGCGA-1	Cardiomyocyte
CTTAATGAGCTGAGGG-1	Cardiomyocyte
CTTAATGAGGTTAGAG-1	Endothelial_cell
CTTACTAGTATACTGG-1	Fibroblast
CTTACTAGTTACTTGC-1	Fibroblast
CTTCACTCAGGCATGA-1	Cardiomyocyte
CTTCTAAGTGCTCACC-1	Endothelial_cell
CTTCTCAAGCCGCAGT-1	Endothelial_cell
CTTCTCAAGGCTACTG-1	Fibroblast
CTTGAATCATGAATAG-1	Pericyte
CTTGCAACAAACAACA-1	Cardiomyocyte
CTTGCATGTCATCATC-1	Endothelial_cell
CTTGCATGTTACGCAA-1	Cardiomyocyte
CTTGCTCAGACTTACA-1	Cardiomyocyte
CTTGCTCAGGCTAGAA-1	Endothelial_cell
CTTGGACCAAGCTAAA-1	Pericyte
CTTGGACCAAGTTATC-1	Cardiomyocyte
CTTGGACCAGGGAGGA-1	Cardiomyocyte
CTTGTCCAGTTTCCGC-1	Pericyte
CTTGTTCCAAGCCAGA-1	Cardiomyocyte
CTTGTTCCAAGCTTTG-1	Cardiomyocyte
CTTGTTCCATTGTCCT-1	Fibroblast
CTTTAGGCAGAGAGCC-1	Fibroblast
CTTTAGTTCATGACCG-1	Cardiomyocyte
CTTTGTCCAATTGACT-1	Endothelial_cell
CTTTGTCCACGGTTTA-1	Fibroblast
GAAAGGCTCGAGGAGT-1	Fibroblast
GAACACAAGGTAAGCA-1	Endothelial_cell
GAACACAAGTACCGCA-1	Cardiomyocyte
GAACCAGCACTAGCGT-1	Endothelial_cell
GAACCAGCATTAAACC-1	Cardiomyocyte
GAACCGCTCGCTTCTA-1	Endothelial_cell
GAACCTGTCAAGCTAC-1	Cardiomyocyte
GAACCTTAGTCAATCA-1	Fibroblast
GAACGAATCGCAATCG-1	Cardiomyocyte
GAACTTATCATCCACC-1	Cardiomyocyte
GAAGCCTGTGTCACGG-1	Fibroblast
GAAGGAACAGCTCATA-1	Endothelial_cell
GAAGGATGTACTGATG-1	Fibroblast
GAAGGATGTCCAAGAC-1	Endothelial_cell
GAAGGCTAGCTCCTAC-1	Fibroblast
GAAGGCTAGTGAGCAA-1	Cardiomyocyte
GAAGTAAGTTGTAAAC-1	Cardiomyocyte
GAAGTATAGCAGGCCT-1	Endothelial_cell
GACACCGGTTACGCGG-1	Cardiomyocyte
GACATTATCACAAGCT-1	Endothelial_cell
GACCGTTCAAATTGCT-1	Cardiomyocyte
GACCTAAGTATTCGTC-1	Fibroblast
GACCTCAAGTTGGCCA-1	Pericyte
GACCTGATCAGCTAAC-1	Endothelial_cell
GACCTGATCTTGCAGG-1	Pericyte
GACCTGCAGACAAACG-1	Cardiomyocyte
GACCTGCAGAGGAGGA-1	Fibroblast
GACCTTTGTGATGAAA-1	Cardiomyocyte
GACGCAACACTCGCTC-1	Fibroblast
GACGTAAAGGGTGGAT-1	Fibroblast
GACTATTCATAAGGAC-1	Cardiomyocyte
GACTATTCATCCATCT-1	Endothelial_cell
GACTCACCAGCATGGA-1	Cardiomyocyte
GACTTAGGTTACGCAA-1	Cardiomyocyte
GACTTAGGTTGGCCGA-1	Pericyte
GACTTAGGTTGTGACA-1	Endothelial_cell
GAGAAACGTAGGTGTC-1	Cardiomyocyte
GAGAGGCGTGCTGGTG-1	Endothelial_cell
GAGAGGCGTGTGAGGA-1	Endothelial_cell
GAGCAAATCGCTCACT-1	Cardiomyocyte
GAGCATGCATCATGGC-1	Endothelial_cell
GAGCCTTCAGCCAGAA-1	Fibroblast
GAGCCTTCATTATGAC-1	Endothelial_cell
GAGCGAAGTTTACTTG-1	Endothelial_cell
GAGCGATAGGGATGCG-1	Cardiomyocyte
GAGCGATAGGGTGGAT-1	Endothelial_cell
GAGCTAGCAGGAACAT-1	Cardiomyocyte
GAGCTAGCAGGCTAGA-1	Cardiomyocyte
GAGCTAGCAGTTTACG-1	Cardiomyocyte
GAGCTAGCATGGAGGC-1	Endothelial_cell
GAGCTGCTCTCACATT-1	Endothelial_cell
GAGCTTAGTGTTGCTT-1	Cardiomyocyte
GAGCTTAGTTATGTGG-1	Cardiomyocyte
GAGGACTAGTCCTTCA-1	Fibroblast
GAGGACTAGTTGTCTT-1	Endothelial_cell
GAGGGAGCACTAAGAA-1	Endothelial_cell
GAGGTACAGGCTACTG-1	Endothelial_cell
GAGGTACAGTCACTCC-1	Endothelial_cell
GAGGTAGGTGGTTAGC-1	Endothelial_cell
GAGGTGAGTCACCAAA-1	Cardiomyocyte
GAGTATCTCCAAGTTA-1	Cardiomyocyte
GAGTCAAAGACACTTA-1	Fibroblast
GAGTCAAAGTTGGCCA-1	Cardiomyocyte
GAGTGATCAGCTCATA-1	Cardiomyocyte
GAGTGTTTCCCTCAGT-1	Cardiomyocyte
GAGTGTTTCCGGTTAG-1	Cardiomyocyte
GAGTTGCGTATACTGG-1	Cardiomyocyte
GATAACGAGGCTGGCT-1	Pericyte
GATAACGAGTCAATCA-1	Fibroblast
GATAGACCAGCTTACA-1	Cardiomyocyte
GATAGACCAGGCGATA-1	Cardiomyocyte
GATCACTAGCCGCAAC-1	Fibroblast
GATCACTAGTAGCTTA-1	Endothelial_cell
GATCGATTCTTGATGA-1	Cardiomyocyte
GATCGCTCAATTAGCT-1	Pericyte
GATGACTTCCTCATGC-1	Cardiomyocyte
GATGCAGCACGTTACA-1	Fibroblast
GATGCATTCATGCTTT-1	Cardiomyocyte
GATGCATTCCCTCATA-1	Cardiomyocyte
GATGCATTCCTAAATG-1	Fibroblast
GATGCATTCGATTATG-1	Endothelial_cell
GATGCATTCTCGCCTG-1	Endothelial_cell
GATGGACAGGCGGGTA-1	Cardiomyocyte
GATGGACAGGGATGAC-1	Fibroblast
GATTAAGCAACCGCCA-1	Cardiomyocyte
GATTAAGCATTAAGCT-1	Fibroblast
GATTAAGCATTTGCTC-1	Cardiomyocyte
GATTACGGTACTTCAC-1	Cardiomyocyte
GATTACTCACGAATTT-1	Endothelial_cell
GATTACTCATATTGAC-1	Endothelial_cell
GATTAGTGTAGTTGGC-1	Cardiomyocyte
GATTATGTCCCATAAA-1	Cardiomyocyte
GATTATGTCCCGTTTA-1	Cardiomyocyte
GATTCAATCCGCCTAT-1	Endothelial_cell
GATTCAGGTATTGTGG-1	Cardiomyocyte
GATTCAGGTGTCCTGC-1	Endothelial_cell
GATTCAGGTGTTTGAG-1	Cardiomyocyte
GATTCATCATCATGGC-1	Cardiomyocyte
GATTCCTGTGCGCAAT-1	Fibroblast
GATTCCTGTTTATCTG-1	Fibroblast
GATTGCAGTACAAAGA-1	Fibroblast
GATTGCGTCCCTCGCA-1	Cardiomyocyte
GATTGCGTCCTCCATA-1	Cardiomyocyte
GATTGGCGTTGCTGGG-1	Endothelial_cell
GATTGGTTCCTAGTCC-1	Fibroblast
GATTGGTTCGTTAAGC-1	Cardiomyocyte
GATTGTTCAGTAGCCT-1	Cardiomyocyte
GATTGTTCAGTGAACG-1	Fibroblast
GATTTGCAGGAGCAAC-1	Fibroblast
GCAAACCGTCATTACC-1	Cardiomyocyte
GCAAACTTCGACAAAG-1	Pericyte
GCAAGCCTCTCCTCTT-1	Cardiomyocyte
GCAATAGAGGTCCTGA-1	Endothelial_cell
GCAATAGAGTTGCGTG-1	Pericyte
GCAATGAAGTTTGTCT-1	Cardiomyocyte
GCAATGTTCACCAATA-1	Endothelial_cell
GCACATTAGGAGCATA-1	Cardiomyocyte
GCACCTAAGGCGCTAC-1	Fibroblast
GCACCTAAGTAAGGGC-1	Endothelial_cell
GCACGAACAGCCAGTT-1	Cardiomyocyte
GCACGAACAGTTATGT-1	Endothelial_cell
GCACGCTAGTTATGTG-1	Fibroblast
GCACGCTAGTTTAACG-1	Cardiomyocyte
GCACTAAGTCTTACTA-1	Cardiomyocyte
GCACTAAGTGACCTGG-1	Endothelial_cell
GCACTAAGTTAGCTGA-1	Fibroblast
GCAGCAACAAGGTACG-1	Cardiomyocyte
GCAGGAAGTTCAAGAT-1	Endothelial_cell
GCAGGATAGGTGTTAC-1	Fibroblast
GCAGGCAAGCAAACCT-1	Fibroblast
GCAGGCAAGCGGATAA-1	Fibroblast
GCAGGCTTCGTACCGA-1	Fibroblast
GCAGGTGAGAGGAGGA-1	Cardiomyocyte
GCAGGTGAGTCAATTG-1	Endothelial_cell
GCAGGTGAGTCACCAG-1	Cardiomyocyte
GCAGGTTGTTTAGCGA-1	Endothelial_cell
GCATGAGCAGCTTAGC-1	Endothelial_cell
GCATGAGCATCGCTTT-1	Endothelial_cell
GCATTAGGTGGTTAGC-1	Pericyte
GCCAACATCACAAGCT-1	Cardiomyocyte
GCCAACATCCTTAGTT-1	Endothelial_cell
GCCAACATCGATTTGA-1	Cardiomyocyte
GCCAACATCGTTTCGC-1	Endothelial_cell
GCCAATAGTTCCGGGA-1	Cardiomyocyte
GCCAATTAGAGGCTAA-1	Fibroblast
GCCAATTAGCGGTTAT-1	Cardiomyocyte
GCCAATTAGTAGCGCC-1	Endothelial_cell
GCCACAATCATTCATC-1	Fibroblast
GCCACAATCGCTCCAT-1	Cardiomyocyte
GCCACAATCGGTTCCT-1	Cardiomyocyte
GCCACAATCTCACAAA-1	Endothelial_cell
GCCACAATCTTGACCC-1	Endothelial_cell
GCCACTAAGATAACCC-1	Endothelial_cell
GCCACTAAGCACAGGG-1	Pericyte
GCCACTAAGCCTGAGC-1	Fibroblast
GCCACTAAGTCGCTAG-1	Cardiomyocyte
GCCAGGAAGAAAGCAT-1	Cardiomyocyte
GCCAGGAAGCTGTCAG-1	Cardiomyocyte
GCCAGGTTCCTAGTCC-1	Pericyte
GCCAGGTTCGATTTAG-1	Pericyte
GCCAGGTTCGCTAAGT-1	Cardiomyocyte
GCCAGGTTCTTAGCCC-1	Fibroblast
GCCATGATCGGCTATG-1	Pericyte
GCCATTACAAGCCACT-1	Cardiomyocyte
GCCATTACACACAATT-1	Fibroblast
GCCCAAATCGATTATG-1	Cardiomyocyte
GCCCATAAGCTTATGA-1	Cardiomyocyte
GCCCATAAGGCCATCA-1	Fibroblast
GCCCGTTGTCATTGTC-1	Fibroblast
GCCCGTTGTGGAGCAA-1	Fibroblast
GCCTAATAGAGGAGTC-1	Cardiomyocyte
GCCTAATAGGCAAGTA-1	Endothelial_cell
GCCTAATAGGTCCAAT-1	Cardiomyocyte
GCCTACTTCACCATTT-1	Cardiomyocyte
GCCTACTTCACTTTAC-1	Pericyte
GCCTACTTCAGCACCA-1	Cardiomyocyte
GCCTACTTCATAAGCC-1	Cardiomyocyte
GCCTACTTCATTCATC-1	Cardiomyocyte
GCCTCAAAGGCTAATC-1	Fibroblast
GCCTCGACACACAATT-1	Cardiomyocyte
GCCTCGACACCTCAGG-1	Cardiomyocyte
GCCTCGACATCCGTAA-1	Fibroblast
GCCTGAGGTTAGCTGA-1	Endothelial_cell
GCCTGCTGTTCAAGCA-1	Cardiomyocyte
GCCTTAACAACCGCCA-1	Cardiomyocyte
GCCTTAACACATTGCA-1	Cardiomyocyte
GCCTTAGAGTGGACAA-1	Cardiomyocyte
GCCTTAGAGTTCCTCA-1	Cardiomyocyte
GCCTTTATCATCCACC-1	Fibroblast
GCCTTTATCTCACAAA-1	Fibroblast
GCCTTTATCTTTGAGA-1	Cardiomyocyte
GCGAAGCCATGAGTTT-1	Cardiomyocyte
GCGAAGTAGTATCGCG-1	Cardiomyocyte
GCGAGTGAGCATGTCG-1	Fibroblast
GCGATTTAGCCACAAT-1	Cardiomyocyte
GCGCCTTGTGTGTCCC-1	Cardiomyocyte
GCGCGATTCAGTGAAG-1	Endothelial_cell
GCGCGATTCATCACTT-1	Pericyte
GCGCGATTCGATCAGT-1	Cardiomyocyte
GCGGAACCAGCCTAAC-1	Fibroblast
GCGGATACAAATGCCC-1	Cardiomyocyte
GCGGATACAAGTAAGC-1	Cardiomyocyte
GCGGGTTTCCAAGTTA-1	Fibroblast
GCGGGTTTCGCATTAA-1	Fibroblast
GCGGGTTTCTCAATTC-1	Cardiomyocyte
GCGTGCTAGAGGAGTC-1	Cardiomyocyte
GCGTTTCTCGGGCCAT-1	Endothelial_cell
GCTAAGAAGCCTCTGT-1	Fibroblast
GCTAAGAAGGAAGCAC-1	Fibroblast
GCTAGCCAGCTATTGA-1	Cardiomyocyte
GCTAGCCAGGCTGTGC-1	Pericyte
GCTAGCTCACAGCCTG-1	Cardiomyocyte
GCTAGCTCAGCATGAG-1	Cardiomyocyte
GCTATCCTCCTTAGTT-1	Cardiomyocyte
GCTATCCTCGAGGAAC-1	Fibroblast
GCTATCCTCTCTAGCC-1	Endothelial_cell
GCTATTGCACATTGCA-1	Fibroblast
GCTCATTGTCACGAAC-1	Pericyte
GCTCATTGTTCGCTTG-1	Fibroblast
GCTCATTGTTGAAGCC-1	Cardiomyocyte
GCTCCTTAGGCTGTGC-1	Cardiomyocyte
GCTCTGGCACCTGGTG-1	Fibroblast
GCTGACATCCACCTTA-1	Endothelial_cell
GCTGACATCCCTCAGT-1	Cardiomyocyte
GCTGCATCACAATGTT-1	Fibroblast
GCTGGATGTTCACCCA-1	Cardiomyocyte
GCTGGTTCAACTCGCG-1	Endothelial_cell
GCTGTAAGTTTACGTC-1	Cardiomyocyte
GCTGTACCAAGCGATG-1	Fibroblast
GCTGTACCACAACAGG-1	Cardiomyocyte
GCTGTACCATGAGCAG-1	Endothelial_cell
GCTGTGATCACTTCAT-1	Fibroblast
GCTGTGCAGACTTACA-1	Fibroblast
GCTGTGCAGCTATTGA-1	Endothelial_cell
GCTTAAATCAGTGAAG-1	Endothelial_cell
GCTTAAATCCCTGTTA-1	Fibroblast
GCTTAAATCCTCAGCT-1	Fibroblast
GCTTAAATCGATTATG-1	Cardiomyocyte
GCTTAACAGACAGGTA-1	Cardiomyocyte
GCTTAACAGGCACAGG-1	Endothelial_cell
GCTTAGTAGGACAATG-1	Cardiomyocyte
GCTTAGTAGTAACAGG-1	Fibroblast
GCTTAGTAGTCATTTC-1	Pericyte
GCTTCGCGTAATGGCC-1	Pericyte
GCTTGTTGTTTACTTG-1	Cardiomyocyte
GCTTTATTCGGCCATA-1	Fibroblast
GCTTTATTCGGCTAGC-1	Endothelial_cell
GCTTTCATCGGGACCT-1	Cardiomyocyte
GGAAACTCACTGGCCA-1	Cardiomyocyte
GGAAACTCAGGCAAGC-1	Cardiomyocyte
GGAACCTGTGAGCGAA-1	Cardiomyocyte
GGAACCTGTTAACAGT-1	Pericyte
GGAACCTGTTTAGTCC-1	Pericyte
GGAACGGTCGTGCCTT-1	Cardiomyocyte
GGAACTAAGGCACAGG-1	Fibroblast
GGAACTAAGGTGCTGC-1	Endothelial_cell
GGAAGCTAGCTGTACG-1	Cardiomyocyte
GGAAGCTAGGCGAATA-1	Pericyte
GGAAGCTAGTCACCAG-1	Pericyte
GGAAGCTAGTTAGCTA-1	Cardiomyocyte
GGAAGCTAGTTATCTC-1	Fibroblast
GGAAGTATCGGGACTC-1	Fibroblast
GGAAGTATCTAAGGAG-1	Pericyte
GGAATCTTCATGCATA-1	Pericyte
GGAATCTTCCCTCACG-1	Pericyte
GGACATAAGGATCCGC-1	Cardiomyocyte
GGACCGAAGCTTAGTA-1	Endothelial_cell
GGACCGAAGGCTAGAA-1	Cardiomyocyte
GGACGAAGTGGAAACG-1	Cardiomyocyte
GGACGGATCCGGTATG-1	Endothelial_cell
GGACGGATCCTAGTCC-1	Cardiomyocyte
GGACGGATCGTGCCTT-1	Fibroblast
GGACTAAAGTTATTCC-1	Endothelial_cell
GGAGCAAGTACCGTTT-1	Fibroblast
GGAGGTTAGGGATGAC-1	Fibroblast
GGAGGTTAGTTGTCAA-1	Endothelial_cell
GGAGTCTGTCATTAGG-1	Endothelial_cell
GGAGTCTGTCCTAACT-1	Endothelial_cell
GGAGTGAGTAGTTAAC-1	Fibroblast
GGAGTGAGTGCTGGTG-1	Cardiomyocyte
GGATACTTCAAGTGTC-1	Endothelial_cell
GGATACTTCAGCCAAT-1	Endothelial_cell
GGATATTGTTTGGGTA-1	Cardiomyocyte
GGATGAATCTCACTAT-1	Cardiomyocyte
GGATGGCCACCTAAGC-1	Cardiomyocyte
GGATGTAAGCTATTGA-1	Fibroblast
GGATGTAAGGCTAATC-1	Cardiomyocyte
GGATGTAAGGCTGTCA-1	Cardiomyocyte
GGATTATGTAGGTTGC-1	Pericyte
GGATTTATCCTTGAGG-1	Cardiomyocyte
GGCAGGATCAGTGAAG-1	Cardiomyocyte
GGCAGGATCCCTTGCG-1	Fibroblast
GGCATTAGTTGCACAA-1	Endothelial_cell
GGCATTGTCACAGCGC-1	Cardiomyocyte
GGCCAACTCAACCAAC-1	Cardiomyocyte
GGCCGTTAGAGGAGTC-1	Cardiomyocyte
GGCCGTTAGCCTGAGC-1	Cardiomyocyte
GGCCTAATCAAGCTAC-1	Endothelial_cell
GGCCTAATCGGGACTC-1	Endothelial_cell
GGCCTCTGTCATTGTC-1	Cardiomyocyte
GGCCTCTGTTGTGACA-1	Cardiomyocyte
GGCCTTAAGGAGGCAT-1	Endothelial_cell
GGCCTTCGTCACAGCG-1	Cardiomyocyte
GGCCTTCGTTGGCGTG-1	Cardiomyocyte
GGCGATACACAAGCCT-1	Cardiomyocyte
GGCGATACACGGTACT-1	Endothelial_cell
GGCGGTTTCGAGGAAC-1	Cardiomyocyte
GGCGTTATCCAAGTTA-1	Endothelial_cell
GGCTATGTCCAAACAC-1	Pericyte
GGCTATGTCCGCCTCA-1	Fibroblast
GGCTATTAGCTAAGTC-1	Endothelial_cell
GGCTATTAGCTTTGGG-1	Endothelial_cell
GGCTATTAGGGACGCA-1	Endothelial_cell
GGCTCAATCGATTTAG-1	Fibroblast
GGCTCAATCTATCGCC-1	Cardiomyocyte
GGCTCACAGAAAGGAA-1	Pericyte
GGCTGAGAGGAGTCGG-1	Cardiomyocyte
GGCTTAAGTATTCGCT-1	Endothelial_cell
GGCTTCAAGAATCTCA-1	Cardiomyocyte
GGCTTCAAGTTAGTTG-1	Cardiomyocyte
GGGAATATCTAATTGG-1	Cardiomyocyte
GGGCATTGTATCTGGA-1	Endothelial_cell
GGGCATTGTGTGAGAG-1	Fibroblast
GGGCCTAGTTACTTCA-1	Endothelial_cell
GGGCCTAGTTGAGCCG-1	Cardiomyocyte
GGGTCACTCAATCATG-1	Cardiomyocyte
GGGTCACTCATTGTCT-1	Fibroblast
GGGTTACGTTCCGGGA-1	Cardiomyocyte
GGGTTTCCAAGCTAAA-1	Cardiomyocyte
GGGTTTGTCATTGACA-1	Cardiomyocyte
GGGTTTGTCCACCTGT-1	Cardiomyocyte
GGTAAACCACTAGCGT-1	Cardiomyocyte
GGTAAACCAGGTATTT-1	Cardiomyocyte
GGTAACTTCGCGACAC-1	Fibroblast
GGTAATTGTGCCGCAA-1	Cardiomyocyte
GGTAATTGTTGCAATG-1	Cardiomyocyte
GGTACAAAGACAAGTG-1	Cardiomyocyte
GGTACAAAGTCATGCG-1	Endothelial_cell
GGTACCGGTGTCACGG-1	Endothelial_cell
GGTACTTAGGATAAAC-1	Endothelial_cell
GGTATTGGTACAATGT-1	Endothelial_cell
GGTCAATTCGGGCCAT-1	Cardiomyocyte
GGTCAATTCGTTCACC-1	Endothelial_cell
GGTCAGGAGATGGACA-1	Endothelial_cell
GGTCATTAGCAAGGGT-1	Cardiomyocyte
GGTCATTAGCCTCTGT-1	Pericyte
GGTCCGTAGGCACAGG-1	Fibroblast
GGTCCGTAGTAAGTCC-1	Fibroblast
GGTCCGTAGTGAAGTG-1	Cardiomyocyte
GGTCCGTAGTGAGCAA-1	Cardiomyocyte
GGTCGGTTCAAAGGCA-1	Cardiomyocyte
GGTCGGTTCAGGAACA-1	Pericyte
GGTCGGTTCCTAAGTA-1	Fibroblast
GGTCGGTTCGCTAAAC-1	Cardiomyocyte
GGTCGGTTCGCTAGCA-1	Endothelial_cell
GGTCTTGAGCATGCAT-1	Fibroblast
GGTGAGCCAGTTTCTC-1	Cardiomyocyte
GGTGAGGTCATTAGGC-1	Endothelial_cell
GGTGAGGTCCGTTAAA-1	Endothelial_cell
GGTGAGGTCGTCAAGT-1	Cardiomyocyte
GGTGAGTAGGACCGCT-1	Cardiomyocyte
GGTGAGTAGGCTAATC-1	Cardiomyocyte
GGTGCTTCATGACTAT-1	Endothelial_cell
GGTGTCCAGCGCTCAA-1	Cardiomyocyte
GGTGTCCAGGTGTTAC-1	Cardiomyocyte
GGTGTGACAATCCTAG-1	Cardiomyocyte
GGTGTTGTCATTCATC-1	Cardiomyocyte
GGTGTTGTCATTGACA-1	Fibroblast
GGTTAATGTTTGTGGA-1	Cardiomyocyte
GGTTACCCAATAGCCC-1	Endothelial_cell
GGTTACCCACCTGCTC-1	Pericyte
GGTTACCCAGCAACAG-1	Endothelial_cell
GGTTAGCGTCAATACG-1	Cardiomyocyte
GGTTAGCGTGAAACAA-1	Cardiomyocyte
GGTTAGCGTTGCACGG-1	Fibroblast
GGTTATATCGATAACC-1	Cardiomyocyte
GGTTATATCTGGCAAT-1	Endothelial_cell
GGTTCCCGTGTTGTAG-1	Endothelial_cell
GGTTGAGCACCTGTAA-1	Endothelial_cell
GGTTGCATCTTCAATC-1	Cardiomyocyte
GGTTGCGGTTAACGGC-1	Cardiomyocyte
GGTTGCTCACAACAGG-1	Endothelial_cell
GGTTGCTCACTTCATC-1	Fibroblast
GGTTGCTCATGGCCTG-1	Cardiomyocyte
GGTTTAATCTAATCAG-1	Cardiomyocyte
GGTTTAATCTAATTGG-1	Cardiomyocyte
GGTTTCCTCCGGTATG-1	Endothelial_cell
GGTTTCCTCCTCAGTC-1	Fibroblast
GGTTTGTAGCGCTCAA-1	Endothelial_cell
GGTTTGTAGCGGTTAT-1	Fibroblast
GGTTTGTAGTCACCAG-1	Fibroblast
GTAAAGCCAGCGCTTG-1	Cardiomyocyte
GTAAGCAAGCCACAAT-1	Endothelial_cell
GTAAGCAAGGAACACA-1	Cardiomyocyte
GTAAGCAAGGACAATG-1	Cardiomyocyte
GTAAGCAAGGTGTTAC-1	Endothelial_cell
GTAAGCGCAAGGCCAA-1	Endothelial_cell
GTAAGGTCAGCACCAT-1	Cardiomyocyte
GTACAATGTTAGAGGG-1	Endothelial_cell
GTACACCCAGGAACCA-1	Cardiomyocyte
GTACGTAGTTAAGCCA-1	Cardiomyocyte
GTACTAATCATTAGGC-1	Endothelial_cell
GTACTTCGTTCACCCA-1	Fibroblast
GTAGCGCTCGCATTAA-1	Fibroblast
GTAGCGCTCTCACTCA-1	Cardiomyocyte
GTAGCGCTCTTGGATA-1	Pericyte
GTAGCTGTCGCTCACT-1	Cardiomyocyte
GTAGGATCAACAGCCT-1	Fibroblast
GTAGGATCACATAACT-1	Pericyte
GTAGGATCATTGTTGG-1	Fibroblast
GTAGGCGAGCAAACCT-1	Endothelial_cell
GTAGGCGAGTCACGAT-1	Cardiomyocyte
GTAGGTGCATGCATAT-1	Cardiomyocyte
GTAGGTGCATGTTGGC-1	Cardiomyocyte
GTAGTTATCAGGAACA-1	Endothelial_cell
GTAGTTATCTACCTGC-1	Cardiomyocyte
GTAGTTTCATGAGCAG-1	Fibroblast
GTATTCAAGCATCCAG-1	Cardiomyocyte
GTATTCAAGCCAAATC-1	Fibroblast
GTATTCAAGCTATATG-1	Cardiomyocyte
GTATTGCAGCTTTGTT-1	Cardiomyocyte
GTATTGTCAGGCTTCG-1	Endothelial_cell
GTCAATATCGCTCACT-1	Cardiomyocyte
GTCAGGCTCCGCACAA-1	Cardiomyocyte
GTCAGGCTCTTGGACG-1	Fibroblast
GTCATCACACCTCAGG-1	Fibroblast
GTCATCACAGCTCATA-1	Cardiomyocyte
GTCATCACATGAGCAG-1	Fibroblast
GTCATCCTCCGCACAA-1	Fibroblast
GTCATTAAGCCTAACG-1	Pericyte
GTCATTAAGTGATTCA-1	Fibroblast
GTCCAAGTCGTGCCTT-1	Fibroblast
GTCCAGGGTCCAAGAC-1	Pericyte
GTCCAGGGTCTAACCT-1	Cardiomyocyte
GTCCATTGTACCTTAC-1	Fibroblast
GTCCGTAAGCATGCAT-1	Cardiomyocyte
GTCCGTAAGGGATGCG-1	Pericyte
GTCCTAGAGTTTCCTG-1	Endothelial_cell
GTCCTCAGTCACCAAA-1	Fibroblast
GTCGAGGAGGAGTCTT-1	Fibroblast
GTCGCAATCCCATAGG-1	Endothelial_cell
GTCGGTTCAGTCTAAT-1	Cardiomyocyte
GTCTAACAGGATGATG-1	Cardiomyocyte
GTCTAACAGTCAGTAC-1	Endothelial_cell
GTCTAATCAGCAACCT-1	Endothelial_cell
GTCTATGCAATTTGGT-1	Fibroblast
GTCTATGCAGGGAGCT-1	Cardiomyocyte
GTCTTGCTCCTACCTA-1	Cardiomyocyte
GTGAACAAGTTCCTCA-1	Cardiomyocyte
GTGAGCGAGGGTTATC-1	Endothelial_cell
GTGATCAGTGATGAGG-1	Cardiomyocyte
GTGCACGGTTCGCGCT-1	Cardiomyocyte
GTGCATTAGCCTCTGT-1	Endothelial_cell
GTGCCTTTCACCAATA-1	Fibroblast
GTGCCTTTCCCTCAAC-1	Pericyte
GTGCCTTTCGCTCACT-1	Cardiomyocyte
GTGCGCAGTGTCCTGC-1	Fibroblast
GTGCTCAAGTTCCTCA-1	Fibroblast
GTGCTCAAGTTCCTGC-1	Cardiomyocyte
GTGCTCCGTTAGCGTA-1	Cardiomyocyte
GTGCTTACACCTGCTC-1	Endothelial_cell
GTGCTTCTCGATAACC-1	Cardiomyocyte
GTGGACACAAGCTAAA-1	Cardiomyocyte
GTGGACACAGTTATCG-1	Endothelial_cell
GTGGATGCACTAAATC-1	Cardiomyocyte
GTGGATGCATGCAACC-1	Fibroblast
GTGTAACTCCTTTACG-1	Endothelial_cell
GTGTGAGCATAAAGCA-1	Endothelial_cell
GTGTGTTAGGAGGCAT-1	Cardiomyocyte
GTGTTCCTCCGGTATG-1	Pericyte
GTTAACGGTGCCGCAA-1	Fibroblast
GTTAAGTGTCATCAAG-1	Fibroblast
GTTAAGTGTGTGAGAG-1	Cardiomyocyte
GTTAAGTGTTGGTTCT-1	Cardiomyocyte
GTTAATGTCAGCTAAC-1	Cardiomyocyte
GTTACGCCACCCTCAC-1	Fibroblast
GTTACGTAGGAGCACG-1	Fibroblast
GTTACTAAGTGTGATC-1	Fibroblast
GTTAGACTCTAGCGAT-1	Endothelial_cell
GTTAGGCGTGGTGAGA-1	Endothelial_cell
GTTCACCTCAGCTAAC-1	Cardiomyocyte
GTTCACCTCCTAAGAC-1	Cardiomyocyte
GTTCATTTCAGCATTA-1	Cardiomyocyte
GTTCATTTCATTGTTC-1	Cardiomyocyte
GTTCCCAGTTTAGCTC-1	Cardiomyocyte
GTTCCTGGTGTGTGGT-1	Endothelial_cell
GTTCCTTCAAACCCTA-1	Cardiomyocyte
GTTCGCGCAAGGATTA-1	Cardiomyocyte
GTTCGCGCATAAGTTC-1	Pericyte
GTTCGCTTCCAACTGG-1	Cardiomyocyte
GTTCTTGTCTAGCGTG-1	Cardiomyocyte
GTTGCCCGTCAACAAT-1	Cardiomyocyte
GTTGCGGGTACCGGAT-1	Pericyte
GTTGGAGCAGGATGGC-1	Fibroblast
GTTGGAGCAGTAAAGC-1	Cardiomyocyte
GTTGGCCAGGCCATCA-1	Cardiomyocyte
GTTGGCGGTTCCTGTG-1	Cardiomyocyte
GTTGTGAGTTGCGGAT-1	Endothelial_cell
GTTGTTGCACCTGGTG-1	Cardiomyocyte
GTTTAACCACAGAAAC-1	Cardiomyocyte
GTTTGCTGTTAATGCG-1	Cardiomyocyte
GTTTGCTGTTTAGTCC-1	Cardiomyocyte
GTTTGTCGTTAGGTTG-1	Cardiomyocyte
TAAAGCCTCAATGAGG-1	Endothelial_cell
TAAAGCCTCCAACTGG-1	Cardiomyocyte
TAACAAGCACTCGCTC-1	Endothelial_cell
TAACCTAAGGCCTAAT-1	Cardiomyocyte
TAAGCCAGTTGTTGTC-1	Cardiomyocyte
TAAGCCTAGCGCTCAA-1	Cardiomyocyte
TAAGCCTAGCTTAGTA-1	Fibroblast
TAAGCCTAGGTGCGGA-1	Cardiomyocyte
TAAGTGCTCCAGGGAG-1	Cardiomyocyte
TAAGTGCTCTTGTTCG-1	Cardiomyocyte
TAATCACCACCAGGTT-1	Endothelial_cell
TAATCACCATAATTGC-1	Pericyte
TAATGCATCGCAAACT-1	Cardiomyocyte
TAATTGCCAAGGCCAA-1	Cardiomyocyte
TAATTGCCATTGGGAG-1	Cardiomyocyte
TACAACATCAAGCGCC-1	Cardiomyocyte
TACAATGTCATAGACC-1	Cardiomyocyte
TACAATGTCATCCACC-1	Cardiomyocyte
TACAATGTCTAAGTGC-1	Endothelial_cell
TACAGGTTCATGGTTA-1	Cardiomyocyte
TACATCAAGTGCACGC-1	Cardiomyocyte
TACCAAATCCTAGTAA-1	Cardiomyocyte
TACCAAATCGCTAAAC-1	Fibroblast
TACCGCAAGCCTCTCG-1	Fibroblast
TACCTCATCCGCAAGC-1	Endothelial_cell
TACCTCATCCTTAGGG-1	Pericyte
TACCTGCTCCTTCGTA-1	Endothelial_cell
TACCTGCTCGAGGAGT-1	Cardiomyocyte
TACCTGCTCTAATTGG-1	Pericyte
TACGCTTGTACCGTTT-1	Cardiomyocyte
TACGGATTCCTAATTC-1	Cardiomyocyte
TACGGTTAGCCATCAG-1	Endothelial_cell
TACGGTTAGCCTGAGC-1	Cardiomyocyte
TACGGTTAGCTTATGA-1	Cardiomyocyte
TACGGTTAGTTATGTG-1	Endothelial_cell
TACGTAATCCCAGTAG-1	Fibroblast
TACGTACAGCATGTTA-1	Fibroblast
TACGTACAGCATTATG-1	Fibroblast
TACGTTAAGATGCCTG-1	Cardiomyocyte
TACTAAGTCCAACTGG-1	Pericyte
TACTAAGTCCTAAGAC-1	Fibroblast
TACTCAAAGCAAGGGT-1	Endothelial_cell
TACTCAAAGGGTTATC-1	Fibroblast
TACTGACAGACTAAGG-1	Cardiomyocyte
TACTGACAGTCACTCC-1	Cardiomyocyte
TACTTCGTCAACAAGG-1	Fibroblast
TACTTCGTCATGCAAC-1	Endothelial_cell
TACTTGTTCATTACTC-1	Endothelial_cell
TACTTGTTCCAGGTCA-1	Fibroblast
TACTTGTTCGACAAAG-1	Endothelial_cell
TAGACCAGTAAGCTCA-1	Cardiomyocyte
TAGACCAGTATTACCC-1	Endothelial_cell
TAGCAGGCATGTTGCA-1	Endothelial_cell
TAGCCGGGTGTAACCA-1	Fibroblast
TAGCCTCTCTTCAATC-1	Cardiomyocyte
TAGCGCGGTAAACAAG-1	Fibroblast
TAGCGGACAGTTGCGT-1	Fibroblast
TAGCGGCTCCTTCTAG-1	Endothelial_cell
TAGCTTAAGTAAGTCC-1	Cardiomyocyte
TAGGAACCAACCGCCA-1	Endothelial_cell
TAGGCTAGTTCACCCA-1	Cardiomyocyte
TAGGCTTAGCATTATG-1	Endothelial_cell
TAGGCTTAGCGCCTTT-1	Cardiomyocyte
TAGGCTTAGGTGTTAC-1	Cardiomyocyte
TAGGCTTAGTCTCACC-1	Cardiomyocyte
TAGGGTTTCGCTCACT-1	Fibroblast
TAGGTGCGTGCTCCAC-1	Cardiomyocyte
TAGGTTATCATTAGTG-1	Cardiomyocyte
TAGTGGCGTGCAATGC-1	Cardiomyocyte
TAGTGGCGTGGGAACA-1	Cardiomyocyte
TAGTTTGAGCTGAGGG-1	Fibroblast
TATAGGTGTGAGGTGA-1	Cardiomyocyte
TATAGGTGTGATGAAA-1	Cardiomyocyte
TATAGGTGTGGTTCTT-1	Fibroblast
TATAGGTGTTGAAGCC-1	Endothelial_cell
TATATCCTCCCTCAAC-1	Cardiomyocyte
TATATCCTCTCCATGC-1	Fibroblast
TATCACAAGCGAGGTG-1	Cardiomyocyte
TATCACAAGGAGGGTT-1	Cardiomyocyte
TATCACGCATTATGGT-1	Cardiomyocyte
TATCCGGAGGTCCACA-1	Cardiomyocyte
TATCGAGGTCAACAAT-1	Endothelial_cell
TATCGAGGTGTTAAAC-1	Fibroblast
TATCGAGGTTGTAACG-1	Cardiomyocyte
TATCGCACATAGCAGG-1	Cardiomyocyte
TATCGCACATTGCGAC-1	Endothelial_cell
TATCGCGAGTCGCTAG-1	Cardiomyocyte
TATGACATCCTTAAGA-1	Endothelial_cell
TATGACTCAGGCTGTT-1	Cardiomyocyte
TATGCATCACCCACCT-1	Cardiomyocyte
TATGGGCGTTGCACGG-1	Endothelial_cell
TATGTGATCAGCTAAC-1	Cardiomyocyte
TATGTGATCGTAACGT-1	Endothelial_cell
TATGTGATCTCACAAA-1	Cardiomyocyte
TATTACCTCGCTTGCT-1	Fibroblast
TATTAGCCATAGACCC-1	Cardiomyocyte
TATTAGGTCAAGGACA-1	Endothelial_cell
TATTAGGTCAGGAAGC-1	Pericyte
TATTCGTTCCTACCTA-1	Pericyte
TATTCGTTCGAGGAGT-1	Fibroblast
TATTTGGAGGCGGGTA-1	Pericyte
TCAAGACTCATGGTGT-1	Fibroblast
TCAAGGAAGGACCTGC-1	Cardiomyocyte
TCAAGGAAGGATTTGC-1	Cardiomyocyte
TCAAGTATCACAGACT-1	Cardiomyocyte
TCACATAAGAAAGCAT-1	Pericyte
TCACATAAGGAAACTG-1	Pericyte
TCACCTCAGCAAGGTA-1	Cardiomyocyte
TCACGGATCATGACCG-1	Cardiomyocyte
TCACTGACACCAGGTT-1	Endothelial_cell
TCACTGACAGTATGTT-1	Endothelial_cell
TCAGGAGCAATATAGG-1	Fibroblast
TCAGGAGCACAAGCCT-1	Cardiomyocyte
TCAGGAGCATCACAGC-1	Fibroblast
TCAGGTTAGCAAGGTA-1	Cardiomyocyte
TCAGGTTAGCTGTAAC-1	Pericyte
TCAGGTTAGTTGGCCA-1	Endothelial_cell
TCAGTAATCGATTTAG-1	Cardiomyocyte
TCAGTAATCTAGCGTG-1	Cardiomyocyte
TCAGTAGGTGCTCCAC-1	Pericyte
TCAGTAGGTTTACGTC-1	Cardiomyocyte
TCATAACCAGTTAGCC-1	Cardiomyocyte
TCATACTTCAAATCGC-1	Cardiomyocyte
TCATACTTCAAGCTTA-1	Fibroblast
TCATACTTCCGGAACC-1	Cardiomyocyte
TCATACTTCCTGTTCA-1	Endothelial_cell
TCATACTTCGGTCAGC-1	Cardiomyocyte
TCATCCATCATGACCG-1	Cardiomyocyte
TCATGAGGTATTACCC-1	Endothelial_cell
TCATGAGGTTTAAAGC-1	Fibroblast
TCATGCCTCATAACCA-1	Cardiomyocyte
TCATGCCTCCGGTTGA-1	Fibroblast
TCATGTTTCCGGTTGA-1	Cardiomyocyte
TCATGTTTCGTTAAGC-1	Endothelial_cell
TCATGTTTCGTTTCCA-1	Cardiomyocyte
TCATTACTCGGCCATA-1	Endothelial_cell
TCATTGTTCATGCGTG-1	Fibroblast
TCATTTGGTAGCTAAT-1	Cardiomyocyte
TCATTTGGTGAAGCCT-1	Cardiomyocyte
TCCACAACATAGACCC-1	Cardiomyocyte
TCCAGCAAGCCGGTAC-1	Endothelial_cell
TCCAGCAAGGCTAGAA-1	Cardiomyocyte
TCCAGCAAGTCATGCG-1	Endothelial_cell
TCCAGGTCAGGACCTT-1	Cardiomyocyte
TCCAGGTCATGAATCT-1	Fibroblast
TCCATAAAGTAAGTGG-1	Endothelial_cell
TCCATGCTCCACCTGT-1	Endothelial_cell
TCCATTGTCACCATTT-1	Fibroblast
TCCATTGTCATTGCGG-1	Endothelial_cell
TCCATTGTCCAACTGG-1	Endothelial_cell
TCCATTGTCCGCCAAA-1	Fibroblast
TCCATTGTCCTCACAC-1	Cardiomyocyte
TCCCGTTAGTTGGCCA-1	Cardiomyocyte
TCCCGTTAGTTTGGTA-1	Fibroblast
TCCCTCACAAACCCTA-1	Cardiomyocyte
TCCCTCACAACTAGAA-1	Cardiomyocyte
TCCCTCACAGCACCAT-1	Endothelial_cell
TCCCTCACAGGCTAGA-1	Cardiomyocyte
TCCGCCATCCTAAGTA-1	Cardiomyocyte
TCCGCCATCGCTAGAT-1	Cardiomyocyte
TCCGGAATCTTGACCC-1	Cardiomyocyte
TCCGGTAAGCTAAGTC-1	Endothelial_cell
TCCTCTAAGTAACTCA-1	Cardiomyocyte
TCCTCTAAGTTCCCAC-1	Pericyte
TCCTGTTCAACAGGAT-1	Pericyte
TCCTGTTCAGGGAGCT-1	Cardiomyocyte
TCCTTAGTCTTGCATT-1	Cardiomyocyte
TCCTTCAAGCCACATG-1	Cardiomyocyte
TCCTTCAAGGAGTCGG-1	Endothelial_cell
TCCTTGCAGTTATCTC-1	Fibroblast
TCCTTTACAAGTGTCC-1	Cardiomyocyte
TCGACAAGTTCACTGT-1	Pericyte
TCGATTAAGTCATTAG-1	Fibroblast
TCGCATTGTCCTAATC-1	Endothelial_cell
TCGCATTGTTAGAGCC-1	Cardiomyocyte
TCGCCCATCCCATAAA-1	Cardiomyocyte
TCGCCCATCTAAATCG-1	Endothelial_cell
TCGCTAACAGCACGTT-1	Cardiomyocyte
TCGGTAAGTGGTGAGA-1	Fibroblast
TCGGTAAGTTATCGAG-1	Endothelial_cell
TCGGTTACACGGTACT-1	Fibroblast
TCGGTTACATCCCTCA-1	Cardiomyocyte
TCGGTTCTCAGTGAAG-1	Cardiomyocyte
TCGGTTCTCCACCTGT-1	Cardiomyocyte
TCGGTTCTCCCTCAAC-1	Cardiomyocyte
TCGGTTCTCCTTCGTA-1	Cardiomyocyte
TCGGTTCTCGGTTCCT-1	Cardiomyocyte
TCGGTTCTCTTAGTGA-1	Cardiomyocyte
TCGTAATCAGGAATCG-1	Cardiomyocyte
TCGTAATCAGGTTATT-1	Cardiomyocyte
TCGTGCTTCAAGGACA-1	Endothelial_cell
TCGTGCTTCCGCATGA-1	Endothelial_cell
TCGTGCTTCGAGGAGT-1	Cardiomyocyte
TCGTTAAAGTCATTAG-1	Pericyte
TCGTTATTCGATATTG-1	Endothelial_cell
TCTAACCGTAATCGTG-1	Cardiomyocyte
TCTAACCGTGTTGCAA-1	Cardiomyocyte
TCTAAGGGTGTCACGG-1	Endothelial_cell
TCTACCTCAACGTGCT-1	Cardiomyocyte
TCTACCTCACCTAATG-1	Cardiomyocyte
TCTACCTCAGTTGCGT-1	Cardiomyocyte
TCTACTAGTGGATTCA-1	Cardiomyocyte
TCTAGCACACGGTACT-1	Fibroblast
TCTCACCAGCATGAAG-1	Fibroblast
TCTCACCAGGACAACA-1	Cardiomyocyte
TCTCACCAGTCAGGCC-1	Cardiomyocyte
TCTCCTCGTCCTTTAA-1	Fibroblast
TCTCGCCCAACCTGGT-1	Cardiomyocyte
TCTCGCCCACCAGGTT-1	Cardiomyocyte
TCTCGCCCACCTCAGG-1	Fibroblast
TCTCGCCCAGCTTACA-1	Cardiomyocyte
TCTGGCTTCACTAATG-1	Cardiomyocyte
TCTGGCTTCACTAGGT-1	Pericyte
TCTGGCTTCGATTTGA-1	Cardiomyocyte
TCTGGCTTCTTACTCG-1	Fibroblast
TCTTAGCGTAATGACT-1	Cardiomyocyte
TCTTAGTTCATTGTTC-1	Cardiomyocyte
TCTTAGTTCCTCGATC-1	Fibroblast
TCTTAGTTCGTTTCGC-1	Cardiomyocyte
TCTTGACGTACTGAAT-1	Fibroblast
TCTTGACGTTAGCCAA-1	Pericyte
TCTTGTCCACAGCCTG-1	Cardiomyocyte
TGAAACTGTCCTAAGA-1	Fibroblast
TGAACAACACATACTG-1	Endothelial_cell
TGAAGGATCATTGCAA-1	Fibroblast
TGAAGGATCGCTAGCA-1	Endothelial_cell
TGACCAAGTCACAGAC-1	Cardiomyocyte
TGACCAAGTTTACTTG-1	Pericyte
TGACCTTGTCGTTACT-1	Cardiomyocyte
TGACTCCTCTTTAAGG-1	Cardiomyocyte
TGACTTAAGAGCCGCT-1	Fibroblast
TGACTTAAGCTTAGTA-1	Cardiomyocyte
TGAGCAAAGCACCACA-1	Endothelial_cell
TGAGCCGGTTTCCTCC-1	Cardiomyocyte
TGAGCTTAGTCGCTAG-1	Endothelial_cell
TGAGGGAGTGGATGTC-1	Cardiomyocyte
TGAGTGAAGGAACCAA-1	Fibroblast
TGAGTGAAGGTGCGGA-1	Endothelial_cell
TGAGTGAAGTAGGCGG-1	Endothelial_cell
TGATCAATCCTTAGTT-1	Cardiomyocyte
TGATCACAGCTAATCA-1	Fibroblast
TGATCGAGTACAAAGA-1	Fibroblast
TGATCGAGTTCAAGCA-1	Cardiomyocyte
TGATGAACATAGGCGA-1	Endothelial_cell
TGATGACTCATGAAGG-1	Cardiomyocyte
TGATGACTCCATTACT-1	Cardiomyocyte
TGATTAGTCAACAAGG-1	Endothelial_cell
TGATTAGTCATGCTTT-1	Cardiomyocyte
TGATTAGTCTGTAAGC-1	Cardiomyocyte
TGCACACCATGAATCT-1	Cardiomyocyte
TGCACTTGTTTAACCC-1	Cardiomyocyte
TGCAGGCTCCTAAATG-1	Fibroblast
TGCATCCTCCTAGTCC-1	Fibroblast
TGCATCCTCGCTAAGT-1	Pericyte
TGCATTAAGCCACAAT-1	Pericyte
TGCCTGTTCAAGTGTC-1	Fibroblast
TGCCTGTTCCAAGTGT-1	Cardiomyocyte
TGCCTGTTCTTCAATC-1	Cardiomyocyte
TGCGCAGGTCCTAACT-1	Cardiomyocyte
TGCGGTTCATCATGGC-1	Cardiomyocyte
TGCGGTTCATTATGCG-1	Fibroblast
TGCTAACAGGAGGTTA-1	Cardiomyocyte
TGCTAACAGTGAGGTA-1	Cardiomyocyte
TGCTAGCCAATTAGGA-1	Cardiomyocyte
TGCTCAACAATTAAGG-1	Endothelial_cell
TGCTCCGTCATTAGTG-1	Cardiomyocyte
TGCTCCGTCCGTCCAT-1	Cardiomyocyte
TGCTCCGTCGGTACGC-1	Cardiomyocyte
TGCTCTCAGTCACTAA-1	Pericyte
TGCTTCATCATGACCG-1	Fibroblast
TGCTTCATCCCTTGCG-1	Cardiomyocyte
TGCTTCATCGGGACCT-1	Cardiomyocyte
TGCTTCCAGGCCTAAT-1	Cardiomyocyte
TGCTTGCTCCAGGTCA-1	Cardiomyocyte
TGCTTGCTCTTTGACT-1	Fibroblast
TGCTTGTGTAACGTGC-1	Fibroblast
TGCTTGTGTTGCACAA-1	Cardiomyocyte
TGCTTTAGTCATCCTG-1	Cardiomyocyte
TGGAACAAGTCCTTCA-1	Fibroblast
TGGACCGGTTCCAGGG-1	Cardiomyocyte
TGGACGGAGTCACTCC-1	Cardiomyocyte
TGGATTGGTATCTGGA-1	Cardiomyocyte
TGGCCATCAGTTAGCC-1	Cardiomyocyte
TGGCCTTTCCGCACAA-1	Cardiomyocyte
TGGCCTTTCCTCGATC-1	Cardiomyocyte
TGGCTAAGTTTCCTCC-1	Cardiomyocyte
TGGCTTTGTTACTTCA-1	Endothelial_cell
TGGCTTTGTTATAGCG-1	Fibroblast
TGGGCATGTAACAGGG-1	Pericyte
TGGGCATGTAAGCTCA-1	Cardiomyocyte
TGGGCATGTTAGTGAT-1	Endothelial_cell
TGGGCCTAGTCTTGAA-1	Cardiomyocyte
TGGTAAACATTCCTCG-1	Endothelial_cell
TGGTAAACATTGCAGC-1	Cardiomyocyte
TGGTAAACATTGTGTG-1	Endothelial_cell
TGGTTAATCCCATAAA-1	Fibroblast
TGGTTCCTCGGCTATG-1	Fibroblast
TGTAAGTGTACGCGCA-1	Endothelial_cell
TGTAAGTGTCACAGCG-1	Cardiomyocyte
TGTATCCGTGTAACCA-1	Fibroblast
TGTATCGCATGGCCCA-1	Pericyte
TGTCAGTAGTGAGCAA-1	Cardiomyocyte
TGTCATAAGGCCAATT-1	Endothelial_cell
TGTCATAAGGCGAAAC-1	Pericyte
TGTCATAAGTGACCTG-1	Cardiomyocyte
TGTCCTGGTTGAAGCC-1	Cardiomyocyte
TGTCCTTCAAGCGATG-1	Cardiomyocyte
TGTCCTTCACATTAAC-1	Cardiomyocyte
TGTGATCAGGATGATG-1	Fibroblast
TGTGATCAGTTTAACG-1	Cardiomyocyte
TGTGCGGGTCATCAAG-1	Endothelial_cell
TGTGCTGAGGACCGCT-1	Cardiomyocyte
TGTGGAGCAATAGCCC-1	Cardiomyocyte
TGTGGCTCACGTGCTG-1	Endothelial_cell
TGTGTGAGTAGGTTAT-1	Fibroblast
TGTGTTAAGCTCGCTT-1	Fibroblast
TGTGTTAAGGTCCAAT-1	Fibroblast
TGTTACTTCAATTACG-1	Cardiomyocyte
TGTTACTTCATAACCA-1	Cardiomyocyte
TGTTAGCAGCTAAAGG-1	Cardiomyocyte
TGTTATGAGAGCCGCT-1	Fibroblast
TGTTATGAGCAGGTGG-1	Cardiomyocyte
TGTTATGAGCTGGACC-1	Cardiomyocyte
TGTTATGAGCTGTACG-1	Fibroblast
TGTTGTAAGACAAACG-1	Cardiomyocyte
TGTTGTAAGTCAATCA-1	Cardiomyocyte
TGTTGTTTCGTTCACC-1	Endothelial_cell
TTAAAGGCACGAATTT-1	Endothelial_cell
TTAACCAAGCTCAATA-1	Endothelial_cell
TTAAGCCAGACAACAG-1	Endothelial_cell
TTAAGGACAACCGCCA-1	Cardiomyocyte
TTAAGGACACTCAACA-1	Cardiomyocyte
TTAAGGACATGTTGTG-1	Fibroblast
TTAAGGTGTTAACGGC-1	Endothelial_cell
TTAAGGTGTTTGGTTC-1	Cardiomyocyte
TTAAGTGTCTTGCAGG-1	Pericyte
TTACAGCAGGAGGCAT-1	Cardiomyocyte
TTACAGCAGGTGAAAT-1	Pericyte
TTAGAAGCACATTAAC-1	Cardiomyocyte
TTAGAAGCACTGACCG-1	Endothelial_cell
TTAGAAGCAGCACCAT-1	Endothelial_cell
TTAGACTCAATTAACC-1	Fibroblast
TTAGACTCAGTAGCCT-1	Endothelial_cell
TTAGCAATCCAGGGAG-1	Endothelial_cell
TTAGCAATCGTTAACA-1	Fibroblast
TTAGCAATCGTTAGTA-1	Cardiomyocyte
TTAGCGGTCAGCAAGA-1	Fibroblast
TTAGGAACAATGAGGT-1	Fibroblast
TTAGGAACAATTGACT-1	Fibroblast
TTAGGATGTAACCTAG-1	Cardiomyocyte
TTAGGATGTGGACCTG-1	Cardiomyocyte
TTAGGCCCAGCATTAT-1	Cardiomyocyte
TTAGGCCCAGTCTATG-1	Fibroblast
TTAGGCCCATTATGCG-1	Pericyte
TTAGGCGTCCGTCCAT-1	Endothelial_cell
TTAGGCGTCTTGCTAT-1	Endothelial_cell
TTAGGCTAGGTTTGAC-1	Cardiomyocyte
TTAGTCAAGGACTTAC-1	Cardiomyocyte
TTAGTCAAGTCACCAG-1	Cardiomyocyte
TTATAGCCATAAAGCA-1	Cardiomyocyte
TTATCCTAGTTTGGTA-1	Endothelial_cell
TTATTGCTCCGGTTGA-1	Cardiomyocyte
TTCAACCGTATACTGG-1	Cardiomyocyte
TTCAACCGTTTGTGGA-1	Pericyte
TTCACTGTCAGAAACG-1	Endothelial_cell
TTCACTGTCATTTGTC-1	Cardiomyocyte
TTCATCCCAGACAAAC-1	Cardiomyocyte
TTCATTCAGGCTACTG-1	Cardiomyocyte
TTCATTCAGGTTAGCT-1	Pericyte
TTCATTCAGTGAGCAA-1	Endothelial_cell
TTCCTCAAGCAGGTTT-1	Cardiomyocyte
TTCCTTCTCCTAGTCC-1	Fibroblast
TTCGCAACAATTGACT-1	Cardiomyocyte
TTCGCAACAGTAAGTA-1	Fibroblast
TTCGCAACATAGACCC-1	Fibroblast
TTGACATCACCAGGTT-1	Cardiomyocyte
TTGACATCAGATAGAC-1	Endothelial_cell
TTGACATCAGGCTTCG-1	Cardiomyocyte
TTGACATCATTGCAGC-1	Cardiomyocyte
TTGACTAAGTTATTCC-1	Pericyte
TTGAGCTAGCATTAGC-1	Endothelial_cell
TTGAGCTAGGAACGGT-1	Cardiomyocyte
TTGAGGCGTTGTTGTC-1	Fibroblast
TTGCAACAGGAACGGT-1	Cardiomyocyte
TTGCAACAGGACCTCA-1	Endothelial_cell
TTGCAACAGTTAGTGC-1	Fibroblast
TTGCAAGGTCACAGCG-1	Fibroblast
TTGCAAGGTCAGGCAT-1	Fibroblast
TTGCAATCATTTAAGC-1	Cardiomyocyte
TTGCAGCCAGTCTAAT-1	Cardiomyocyte
TTGCATTTCCGTAAAC-1	Cardiomyocyte
TTGCATTTCCTCAGCT-1	Pericyte
TTGCCCGTCATAACCA-1	Fibroblast
TTGCCCGTCCAGGTCA-1	Endothelial_cell
TTGCTTTAGCCTTAAA-1	Endothelial_cell
TTGGAGGCACAGGGAC-1	Endothelial_cell
TTGGATATCCTAAATG-1	Pericyte
TTGGATTCAAGTAAGC-1	Endothelial_cell
TTGGATTCAATGCGCT-1	Endothelial_cell
TTGGATTCATCATGGC-1	Endothelial_cell
TTGGCTGAGCCTGTTC-1	Cardiomyocyte
TTGGCTGAGGACTTAC-1	Cardiomyocyte
TTGGCTGAGTCGCTAG-1	Endothelial_cell
TTGGCTTGTGCTGGTG-1	Endothelial_cell
TTGGGCGGTGGACCTG-1	Fibroblast
TTGGGTTAGGTGAAAT-1	Cardiomyocyte
TTGTAAGTCATGTTTC-1	Cardiomyocyte
TTGTAAGTCCCATAGG-1	Fibroblast
TTGTAAGTCTGCAAAC-1	Cardiomyocyte
TTGTCAAAGAATCTCA-1	Endothelial_cell
TTGTCCATCCTCCATA-1	Fibroblast
TTGTCCCAGGGTTATC-1	Fibroblast
TTGTCCCAGTAAAGGT-1	Cardiomyocyte
TTGTGAGGTGATGAGG-1	Cardiomyocyte
TTGTGCGAGCTCATAA-1	Cardiomyocyte
TTGTGTGCATAAGCAA-1	Cardiomyocyte
TTGTGTGCATGAATCT-1	Fibroblast
TTGTTCCCATCTTGAG-1	Cardiomyocyte
TTGTTGCGTGAGCACT-1	Cardiomyocyte
TTGTTGCGTTAGCATG-1	Fibroblast
TTGTTTGGTGAATCGC-1	Endothelial_cell
TTTAACGAGGCGTAAA-1	Pericyte
TTTAACGAGTGAGCAA-1	Pericyte
TTTAAGCCAAATACCT-1	Cardiomyocyte
TTTAAGCCAGGTTACC-1	Fibroblast
TTTACGAAGCCTGGTA-1	Endothelial_cell
TTTACGAAGGGTGGAT-1	Endothelial_cell
TTTACGAAGGTCCAAT-1	Endothelial_cell
TTTACGAAGGTCGAGG-1	Cardiomyocyte
TTTACGAAGTAAGTCC-1	Fibroblast
TTTACGCGTCCGGTTC-1	Cardiomyocyte
TTTAGCAAGAAGCTAG-1	Endothelial_cell
TTTAGCTTCACACAGT-1	Cardiomyocyte
TTTAGCTTCATTAGGC-1	Cardiomyocyte
TTTAGGATCAAAGGCA-1	Pericyte
TTTAGGATCAATGACC-1	Cardiomyocyte
TTTATGGAGGCTAGAA-1	Cardiomyocyte
TTTCACCCAAGTTATC-1	Fibroblast
TTTCAGTTCCGGGACT-1	Fibroblast
TTTCAGTTCGGGATTT-1	Cardiomyocyte
TTTCATCAGTTAGAGG-1	Cardiomyocyte
TTTCCTGAGTCACCAG-1	Cardiomyocyte
TTTCGTCCACCTGCTC-1	Endothelial_cell
TTTCTCACACGGTTTA-1	Pericyte
TTTCTCACAGCTAACC-1	Endothelial_cell
TTTCTTGCAACTAGGG-1	Endothelial_cell
TTTGACCGTCGCAAAC-1	Endothelial_cell
TTTGACCGTGGATTCA-1	Endothelial_cell
TTTGACTTCACTAGGT-1	Cardiomyocyte
TTTGAGTCACTGGCCA-1	Endothelial_cell
TTTGCATTCGATTTGA-1	Fibroblast
TTTGCATTCTCTAGCC-1	Endothelial_cell
TTTGCGACAGGCTAGA-1	Fibroblast
TTTGCGACATGTGGGA-1	Pericyte
TTTGGCTGTGAATCGC-1	Cardiomyocyte
TTTGGTGCATGAGTTT-1	Cardiomyocyte
TTTGTCCCACAAACTT-1	Cardiomyocyte
TTTGTCCCAGCACGTT-1	Cardiomyocyte
TTTGTGAAGCCTAACG-1	Fibroblast
TTTGTGAAGCTTCTCA-1	Endothelial_cell
TTTGTGGCACCCTCAC-1	Cardiomyocyte
TTTGTGGCAGGTTACC-1	Cardiomyocyte
TTTGTGGCATAAGTCT-1	Cardiomyocyte
TTTGTTGGTGAAGCCT-1	Cardiomyocyte
