Index	Cell_type
AAACAGCCAATTGAGA-1	Endothelial
AAACAGCCACCATATG-1	Myeloid
AAACAGCCACGTAATT-1	Endothelial
AAACATGCAACTGGGA-1	Cardiomyocytes
AAACATGCAGAAATGC-1	Cardiomyocytes
AAACCAACAATCCTGA-1	Cardiomyocytes
AAACCAACAATGAAGC-1	Smooth.muscle
AAACCAACAGGCAAGC-1	Cardiomyocytes
AAACCAACAGTGAACG-1	Fibroblasts
AAACCAACATGTCAAT-1	Cardiomyocytes
AAACCGAAGCGAGCGA-1	Adipocytes
AAACCGAAGCTAAGTC-1	Cardiomyocytes
AAACCGAAGCTGGACC-1	Cardiomyocytes
AAACCGCGTAACCAGC-1	Endothelial
AAACCGCGTAAGCTTG-1	Fibroblasts
AAACCGCGTTAAATGC-1	Smooth.muscle
AAACCGGCACAAGCCT-1	Pericytes
AAACGCGCAAGGTGCA-1	Cardiomyocytes
AAACGGATCAAGTGTC-1	Endothelial
AAACGGATCATGGTGT-1	Cardiomyocytes
AAACGGATCTAACCAA-1	Fibroblasts
AAACGGATCTTGACCC-1	Adipocytes
AAAGCAAGTAGCTGGT-1	Pericytes
AAAGCAAGTCTAACCT-1	Cardiomyocytes
AAAGCACCATCAGCAC-1	Endothelial
AAAGCCCGTGAAACAA-1	Cardiomyocytes
AAAGCCGCACAGACTC-1	Pericytes
AAAGCCGCACCTGCCT-1	Cardiomyocytes
AAAGCCGCAGGCGATA-1	Neuronal
AAAGCCGCATCATGGC-1	Pericytes
AAAGCCGCATCGTTCT-1	Fibroblasts
AAAGCGGGTACTGAAT-1	Endothelial
AAAGCGGGTCTAACCT-1	Fibroblasts
AAAGCTTGTCGCGCAA-1	Fibroblasts
AAAGGACGTAAAGCAA-1	Cardiomyocytes
AAAGGAGCAACGTGCT-1	Endothelial
AAAGGAGCAATAATGG-1	Myeloid
AAAGGAGCACCCACAG-1	Endothelial
AAAGGAGCATTTAAGC-1	Fibroblasts
AAAGGCTCAGCCAGTT-1	Myeloid
AAAGGTTAGAAGGTGC-1	Cardiomyocytes
AAAGGTTAGACTCGCA-1	Endothelial
AAAGGTTAGGCGTAAA-1	Fibroblasts
AAATGCCTCACTCGCT-1	Cardiomyocytes
AAATGCCTCATGCATA-1	Cardiomyocytes
AAATGCCTCCGCTAGA-1	Endothelial
AAATGCCTCGATTATG-1	Cardiomyocytes
AAATGGCCAATCATGT-1	Pericytes
AACAAAGGTGTGTCCC-1	Cardiomyocytes
AACAAAGGTTACATCC-1	Cardiomyocytes
AACAAAGGTTAGGCGT-1	Endothelial
AACAAAGGTTGTCATC-1	Cardiomyocytes
AACAAAGGTTTATTCG-1	Fibroblasts
AACAAGCCAAACGGGC-1	Fibroblasts
AACAAGCCAAAGGTAC-1	Adipocytes
AACAGCAAGGACCAGG-1	Pericytes
AACAGCAAGTTAGAGG-1	Cardiomyocytes
AACAGCAAGTTTCCGC-1	Fibroblasts
AACAGGATCTTAGTGA-1	Cardiomyocytes
AACATAGCAATTGACT-1	Fibroblasts
AACATCATCACTCAAA-1	Cardiomyocytes
AACATCATCAGCACGC-1	Cardiomyocytes
AACATCATCTAATCCT-1	Cardiomyocytes
AACCGCTCAACAACAA-1	Cardiomyocytes
AACCGCTCACCTACGG-1	Cardiomyocytes
AACCGCTCACGAATCC-1	Cardiomyocytes
AACCGGCTCGAAGCGG-1	Cardiomyocytes
AACCTAATCAAACCGT-1	Pericytes
AACCTAATCCGGTTGA-1	Fibroblasts
AACCTAATCGATAACC-1	Fibroblasts
AACCTAATCGCAATCG-1	Myeloid
AACCTAATCGGTCAAT-1	Fibroblasts
AACCTCACATCATGGC-1	Pericytes
AACCTTAAGTGAACCT-1	Fibroblasts
AACGACAAGGAAACTG-1	Cardiomyocytes
AACGACAAGGGACTAA-1	Cardiomyocytes
AACGCCCAGAGGGACT-1	Endothelial
AACGCCCAGGATGATG-1	Endothelial
AACGGTAAGTCCTTTG-1	Cardiomyocytes
AACTACTCATGTTGTG-1	Endothelial
AACTAGCTCTAATCAG-1	Cardiomyocytes
AACTGTTCAAGGACCA-1	Cardiomyocytes
AACTGTTCAATAGCAA-1	Endothelial
AACTGTTCACGTAATT-1	Cardiomyocytes
AACTTAGTCACCTGTC-1	Myeloid
AAGAATCAGTAACTCA-1	Cardiomyocytes
AAGACAAGTTAAGCGC-1	Fibroblasts
AAGACAAGTTGGGTTA-1	Cardiomyocytes
AAGACAAGTTTCCTCC-1	Cardiomyocytes
AAGACATAGCCAAATC-1	Cardiomyocytes
AAGACCAAGCACTTGG-1	Cardiomyocytes
AAGACCAAGGTCCTAG-1	Endothelial
AAGCAAGTCCGGTTGA-1	Cardiomyocytes
AAGCATGAGATGCCTG-1	Fibroblasts
AAGCATGAGGAGGTTA-1	Pericytes
AAGCATGAGGCGCTAC-1	Cardiomyocytes
AAGCCACGTACCGGAT-1	Cardiomyocytes
AAGCCACGTGGGTGAA-1	Cardiomyocytes
AAGCCACGTTTAGCGA-1	Endothelial
AAGCCACGTTTATCGC-1	Pericytes
AAGCCTCCAAATTGCT-1	Cardiomyocytes
AAGCCTCCACAACCTA-1	Cardiomyocytes
AAGCCTGTCGAAGTAG-1	Cardiomyocytes
AAGCCTTAGCGCCTAA-1	Cardiomyocytes
AAGCCTTAGTCAATCA-1	Cardiomyocytes
AAGCGAATCCTCACTA-1	Endothelial
AAGCGAATCCTGATTT-1	Cardiomyocytes
AAGCGAGGTAGACAAA-1	Cardiomyocytes
AAGCGAGGTGGACCTG-1	Fibroblasts
AAGCGCTGTATTGCAG-1	Cardiomyocytes
AAGCGCTGTCCCGGAA-1	Adipocytes
AAGCGCTGTGATGAAA-1	Fibroblasts
AAGCGGGTCATTGCGG-1	Endothelial
AAGCGGGTCCTTAATC-1	Fibroblasts
AAGCTAGAGTTACCGG-1	Fibroblasts
AAGCTATGTGCAATGC-1	Endothelial
AAGCTCCCAAACTAAG-1	Fibroblasts
AAGCTCCCAATCGCAC-1	Endothelial
AAGCTTGGTATGGTGC-1	Endothelial
AAGGATCCAAGCTAAA-1	Cardiomyocytes
AAGGATCCACCCACCT-1	Cardiomyocytes
AAGGATCCAGTTTACG-1	Cardiomyocytes
AAGGATGTCAGTTCCC-1	Cardiomyocytes
AAGGATGTCATAACCA-1	Cardiomyocytes
AAGGCCCTCACTAGGT-1	Adipocytes
AAGGTATAGAACAAGT-1	Fibroblasts
AAGGTCAAGCCGCTTT-1	Fibroblasts
AAGGTCAAGCGCCTTT-1	Adipocytes
AAGGTCAAGGAGCACG-1	Cardiomyocytes
AAGTAGCCAAACCCTA-1	Cardiomyocytes
AAGTAGCCATGCTCCC-1	Cardiomyocytes
AAGTCTATCCGGTATG-1	Cardiomyocytes
AAGTCTATCGCTAAGT-1	Endothelial
AAGTCTATCTGGCATG-1	Neuronal
AAGTGAAGTCCGGTTC-1	Cardiomyocytes
AAGTGAAGTTAGACCA-1	Cardiomyocytes
AAGTGAAGTTCCAGGG-1	Endothelial
AAGTGAAGTTTGACCT-1	Pericytes
AAGTGCAAGCACAGCC-1	Endothelial
AAGTGCAAGCTACTGG-1	Cardiomyocytes
AAGTGTTGTTCCTGTG-1	Endothelial
AAGTTACGTAGGTTAT-1	Pericytes
AAGTTACGTTAAGTGT-1	Fibroblasts
AAGTTTGTCATTGTCT-1	Fibroblasts
AATACCGGTACAAAGA-1	Fibroblasts
AATCAGGAGTGAGCGG-1	Cardiomyocytes
AATCATCCAACAGGTG-1	Cardiomyocytes
AATCATGTCACGCGGT-1	Cardiomyocytes
AATCCGTAGCATGACT-1	Cardiomyocytes
AATCCGTAGTCACCAG-1	Pericytes
AATCCGTAGTCCTTCA-1	Fibroblasts
AATCCTAAGGGTTATC-1	Fibroblasts
AATCCTAAGTAGCGGG-1	Smooth.muscle
AATCCTAAGTAGGATG-1	Cardiomyocytes
AATCCTAAGTCCTTTG-1	Cardiomyocytes
AATCTCAAGTAGCGGG-1	Cardiomyocytes
AATCTTGAGCAACAAG-1	Cardiomyocytes
AATCTTGAGCATGACT-1	Pericytes
AATCTTGAGCCTAATA-1	Cardiomyocytes
AATCTTGAGTAGCCAT-1	Fibroblasts
AATGAAGGTAGGATTT-1	Cardiomyocytes
AATGAAGGTCGCAATA-1	Cardiomyocytes
AATGAAGGTCGTTACT-1	Cardiomyocytes
AATGCATGTTGAGCCG-1	Myeloid
AATGCGCGTCCGGTTC-1	Fibroblasts
AATGCGCGTTACATCC-1	Cardiomyocytes
AATGTCCAGACAACGA-1	Cardiomyocytes
AATGTCCAGCTCCCTG-1	Cardiomyocytes
AATTACCCAAAGGCCA-1	Cardiomyocytes
AATTAGGCAAACTAAG-1	Cardiomyocytes
AATTAGGCACGGTACT-1	Myeloid
AATTGACGTTGGCCGA-1	Cardiomyocytes
AATTGACGTTGTTGGA-1	Cardiomyocytes
AATTGCCAGCTAAGTC-1	Cardiomyocytes
AATTGCCAGGCTAATC-1	Cardiomyocytes
AATTGCTCATGAAATG-1	Fibroblasts
AATTGCTCATTGTGAT-1	Cardiomyocytes
AATTGGACAATAGCAA-1	Fibroblasts
AATTGGACACCTGCCT-1	Pericytes
AATTGGACAGACAAAC-1	Endothelial
AATTGGACAGTTAGCC-1	Pericytes
AATTGGGAGGAAGCAC-1	Neuronal
AATTGGGAGGACGTAA-1	Pericytes
AATTGTGTCATTTGTC-1	Smooth.muscle
AATTGTGTCCACAATA-1	Cardiomyocytes
AATTGTGTCCAGGTTG-1	Cardiomyocytes
AATTGTGTCTACTAAG-1	Cardiomyocytes
AATTTCCTCAGTTCCC-1	Cardiomyocytes
AATTTGCCAACCCTAA-1	Fibroblasts
AATTTGGTCACCGGTA-1	Fibroblasts
AATTTGGTCAGGATGA-1	Endothelial
ACAAACTGTTTGGCGG-1	Cardiomyocytes
ACAAAGGTCCGGAACC-1	Cardiomyocytes
ACAAAGGTCTAGCGAT-1	Fibroblasts
ACAACACTCAATACGC-1	Cardiomyocytes
ACAACACTCAGGAACA-1	Cardiomyocytes
ACAACACTCGCAGGCT-1	Cardiomyocytes
ACAACACTCTTGTCTG-1	Neuronal
ACAACATGTCACAAAT-1	Cardiomyocytes
ACACAATGTATACTGG-1	Cardiomyocytes
ACACAATGTTGGGTTA-1	Neuronal
ACACCTTGTTGCACAA-1	Endothelial
ACACGGACAATCCCTT-1	Endothelial
ACACTAATCACAGCCA-1	Pericytes
ACACTAGGTTGTCATC-1	Fibroblasts
ACAGCCGGTAAGGTCC-1	Fibroblasts
ACAGCCGGTGGGTACT-1	Cardiomyocytes
ACAGGAATCATTAGTG-1	Fibroblasts
ACAGGAATCCTTAGTT-1	Endothelial
ACAGGAATCTACCTAT-1	Endothelial
ACAGGATCAAGTGTTT-1	Cardiomyocytes
ACAGGATCAATTAAGG-1	Fibroblasts
ACAGGATCAGGAACTG-1	Endothelial
ACAGGATCATCCATCT-1	Cardiomyocytes
ACAGGATCATGCTATG-1	Cardiomyocytes
ACAGGCTGTTTGCGCC-1	Cardiomyocytes
ACAGGTAAGAACAAGT-1	Cardiomyocytes
ACATAGCTCGCTAGAT-1	Cardiomyocytes
ACATCATCATAGTCAT-1	Endothelial
ACATTAGTCACAGCCA-1	Cardiomyocytes
ACCAAACTCATTTAGG-1	Pericytes
ACCAAACTCTGTAATG-1	Myeloid
ACCAAACTCTTAAGTG-1	Cardiomyocytes
ACCAAGCGTCCTAATC-1	Cardiomyocytes
ACCAAGCGTGATGATT-1	Endothelial
ACCAAGCGTTACCGGG-1	Fibroblasts
ACCAAGTTCAGTGAAG-1	Fibroblasts
ACCAATATCATTAGGC-1	Cardiomyocytes
ACCAATATCCGTTAAA-1	Endothelial
ACCAATATCTTAGTCT-1	Fibroblasts
ACCACACCAGCTTACA-1	Fibroblasts
ACCACACCAGTATGTT-1	Fibroblasts
ACCACATAGCAAGGTA-1	Fibroblasts
ACCACATAGGATTTGC-1	Pericytes
ACCACATAGTAACGAG-1	Myeloid
ACCACATAGTAGCGCC-1	Cardiomyocytes
ACCAGCTCAAACGCGA-1	Fibroblasts
ACCAGCTCAAATACCT-1	Cardiomyocytes
ACCAGCTCAGCCTGCA-1	Cardiomyocytes
ACCAGGCTCTGTGCCT-1	Cardiomyocytes
ACCAGGGAGACTCGCA-1	Cardiomyocytes
ACCAGGGAGCGAGGTG-1	Cardiomyocytes
ACCAGGGAGGCTTAGT-1	Cardiomyocytes
ACCATAATCCATCAGG-1	Smooth.muscle
ACCATAATCCCATAGG-1	Cardiomyocytes
ACCATAATCCCGTTTA-1	Cardiomyocytes
ACCATAATCTAATCAG-1	Cardiomyocytes
ACCATTAAGCCGCTTT-1	Cardiomyocytes
ACCATTAAGTAGGATG-1	Myeloid
ACCCAACCACAATGTT-1	Cardiomyocytes
ACCCAACCAGCCAGAA-1	Smooth.muscle
ACCCAACCAGTCTAGC-1	Cardiomyocytes
ACCCAACCATACCCGG-1	Fibroblasts
ACCCAACCATAGCGGA-1	Cardiomyocytes
ACCCAGGGTAGCCTAA-1	Cardiomyocytes
ACCCAGGGTTCCAGGG-1	Cardiomyocytes
ACCCGCTGTACCGAAC-1	Endothelial
ACCCGCTGTTGTTGCT-1	Cardiomyocytes
ACCCGGTAGGAGCATA-1	Fibroblasts
ACCCGGTAGTTGCGTG-1	Cardiomyocytes
ACCCGGTAGTTGTCAA-1	Fibroblasts
ACCCGGTAGTTTCCTG-1	Cardiomyocytes
ACCCGTAAGCTTCCCG-1	Endothelial
ACCCGTAAGGAGTCTT-1	Cardiomyocytes
ACCCGTAAGGGACCTC-1	Cardiomyocytes
ACCCTCCCAACAGCCT-1	Pericytes
ACCCTGTTCAATGAGG-1	Endothelial
ACCCTGTTCGAGGAAC-1	Cardiomyocytes
ACCCTGTTCGCTTGCT-1	Cardiomyocytes
ACCGAAGCAAACAACA-1	Fibroblasts
ACCGCAATCGGCTAGC-1	Fibroblasts
ACCGCAATCTTAAGTG-1	Cardiomyocytes
ACCTAAGGTACCGAAC-1	Fibroblasts
ACCTAAGGTCATCCTG-1	Fibroblasts
ACCTAAGGTTTAACCC-1	Myeloid
ACCTACCTCTATCGCC-1	Cardiomyocytes
ACCTCACTCCGTCCAT-1	Endothelial
ACCTCACTCTCCTCAA-1	Cardiomyocytes
ACCTCACTCTCGCCTG-1	Endothelial
ACCTCACTCTGTTCAT-1	Pericytes
ACCTGGTCATCCCGCT-1	Cardiomyocytes
ACCTGTTGTTAGTACG-1	Cardiomyocytes
ACCTTCATCACAGCCA-1	Fibroblasts
ACCTTCCAGACACCGC-1	Cardiomyocytes
ACCTTCCAGGGCCACT-1	Fibroblasts
ACCTTCCAGGTTAGCT-1	Cardiomyocytes
ACCTTGCTCGCTATGG-1	Fibroblasts
ACCTTGCTCTTGAGGT-1	Fibroblasts
ACCTTGTGTCAACAAT-1	Cardiomyocytes
ACCTTGTGTTAATGCG-1	Cardiomyocytes
ACGAACAAGCTTAGCG-1	Cardiomyocytes
ACGAAGTCACAGCCAT-1	Cardiomyocytes
ACGAATCTCCCTGGTT-1	Endothelial
ACGACAAAGGTCCACA-1	Cardiomyocytes
ACGACAAAGTTGCGTG-1	Fibroblasts
ACGACTTAGGCTAATC-1	Cardiomyocytes
ACGAGTAAGACAAACG-1	Pericytes
ACGAGTAAGGCCTGGT-1	Myeloid
ACGAGTAAGGCGAAAC-1	Cardiomyocytes
ACGCACGGTAGTCAAT-1	Endothelial
ACGCACGGTCACAGCG-1	Fibroblasts
ACGCACGGTCCCGAAG-1	Pericytes
ACGCCACAGAATGACG-1	Fibroblasts
ACGCCACAGGTACCGC-1	Fibroblasts
ACGCCTAAGTATGTGC-1	Endothelial
ACGCCTTTCATGGCTG-1	Cardiomyocytes
ACGCCTTTCTTAATGG-1	Endothelial
ACGCCTTTCTTTAGGA-1	Cardiomyocytes
ACGCTTGAGGTAGCTT-1	Pericytes
ACGGGAAGTTACTAGG-1	Myeloid
ACGGTTAGTGCCGCAA-1	Endothelial
ACGGTTAGTTGTCCAT-1	Endothelial
ACGGTTAGTTTAGCTC-1	Endothelial
ACGGTTTAGCGCCTAA-1	Cardiomyocytes
ACGTACCCACAGACTC-1	Pericytes
ACGTCCAAGCTTTGTT-1	Cardiomyocytes
ACGTCCAAGGAAGCTA-1	Pericytes
ACGTCCAAGTCAATCA-1	Endothelial
ACGTCCAAGTCGCTAG-1	Cardiomyocytes
ACGTCCTTCAGGGCCT-1	Fibroblasts
ACGTCCTTCCTCATCA-1	Cardiomyocytes
ACGTCCTTCGAAGCGG-1	Cardiomyocytes
ACGTCCTTCGATCAGT-1	Endothelial
ACGTCCTTCTACTAAG-1	Cardiomyocytes
ACGTTACAGCGGATAA-1	Fibroblasts
ACGTTACAGTTTCCGC-1	Cardiomyocytes
ACGTTGTAGGGATGAC-1	Fibroblasts
ACGTTGTAGTGAACGA-1	Cardiomyocytes
ACTAAAGCAATATGGA-1	Fibroblasts
ACTAAAGCATCAGTAT-1	Cardiomyocytes
ACTAACCAGAACCTGT-1	Fibroblasts
ACTAACCAGATTCCTT-1	Smooth.muscle
ACTAACCAGTTCCTGC-1	Endothelial
ACTAACGGTTTGCGAA-1	Cardiomyocytes
ACTAACTCAGCAAATA-1	Fibroblasts
ACTAACTCAGGATAAC-1	Cardiomyocytes
ACTAATCCACAAAGAC-1	Endothelial
ACTAATCCACAGGATG-1	Cardiomyocytes
ACTATCCGTCCTAATC-1	Cardiomyocytes
ACTATCCGTTATCCTA-1	Smooth.muscle
ACTATCCGTTCGGTAA-1	Endothelial
ACTATGTCAATTAGCT-1	Pericytes
ACTATGTCATAATGTC-1	Endothelial
ACTCACCTCATCCTCA-1	Fibroblasts
ACTCACCTCCAATAGC-1	Cardiomyocytes
ACTCACCTCTTGGACG-1	Fibroblasts
ACTCACTGTAGTAAGA-1	Fibroblasts
ACTCACTGTTCGGTAA-1	Fibroblasts
ACTCGCGCAAAGCTAA-1	Cardiomyocytes
ACTCGCGCAACACCTA-1	Cardiomyocytes
ACTCGCGCAATTTGGT-1	Cardiomyocytes
ACTCGCGCACATACTG-1	Cardiomyocytes
ACTCGCGCATGACTAT-1	Cardiomyocytes
ACTCGCTTCGATAACC-1	Pericytes
ACTGAAACAATTAGGA-1	Cardiomyocytes
ACTGAAACACAACCTA-1	Endothelial
ACTGAATGTCCGGTTC-1	Endothelial
ACTTACAAGGTCCTAG-1	Fibroblasts
ACTTACAAGTGCACGC-1	Smooth.muscle
ACTTACTTCGCTATAA-1	Fibroblasts
ACTTAGGGTGCATTTC-1	Fibroblasts
ACTTAGTCAATGCCCG-1	Fibroblasts
ACTTAGTCAGGCAAGC-1	Cardiomyocytes
ACTTATCTCCAGCACA-1	Endothelial
ACTTCGCTCCCTCTAA-1	Endothelial
ACTTGAATCCGCTAGA-1	Endothelial
ACTTGCACAAACCTAT-1	Fibroblasts
ACTTGCACAAGCTTTG-1	Fibroblasts
ACTTGCACACAGCCAT-1	Smooth.muscle
ACTTGCACAGCCAGAA-1	Endothelial
ACTTGCACAGTCTAAT-1	Cardiomyocytes
ACTTGCACATGGCCCA-1	Pericytes
ACTTGTAAGGTCCACA-1	Fibroblasts
ACTTGTCGTAAGGTTT-1	Cardiomyocytes
ACTTTGTTCCCGTTGT-1	Endothelial
ACTTTGTTCCGTTATT-1	Cardiomyocytes
ACTTTGTTCTCACATT-1	Smooth.muscle
AGAAACTAGCACAGCC-1	Cardiomyocytes
AGAAACTAGCAGGTTT-1	Cardiomyocytes
AGAAACTAGCGATACT-1	Endothelial
AGAAACTAGGACTTAC-1	Cardiomyocytes
AGAAACTAGGTTTACA-1	Pericytes
AGAAACTAGTATTGGC-1	Cardiomyocytes
AGAAAGGCAAGTGAAC-1	Myeloid
AGAAAGGCAGCTAACC-1	Endothelial
AGAAAGGCATTGCGTA-1	Cardiomyocytes
AGAACAAGTACTTAGG-1	Cardiomyocytes
AGAACAAGTCGTAAAT-1	Cardiomyocytes
AGAACAAGTGTCACGG-1	Fibroblasts
AGAACAAGTTGCTTCG-1	Endothelial
AGAACAAGTTTACTTG-1	Endothelial
AGAACCAAGGCCGGAA-1	Cardiomyocytes
AGAACCAAGGCGAAAC-1	Endothelial
AGAACCGCAGAGGGAG-1	Cardiomyocytes
AGAAGGTGTACGGGTT-1	Fibroblasts
AGAATCGAGGCCTAAT-1	Endothelial
AGACAATAGCTAATTG-1	Cardiomyocytes
AGACAATAGCTCCCTG-1	Cardiomyocytes
AGACACGCAAGCTTTG-1	Fibroblasts
AGACTATGTAGCTGCG-1	Cardiomyocytes
AGAGAGGAGGCTGGCT-1	Cardiomyocytes
AGAGATTAGCGGCTGT-1	Pericytes
AGAGATTAGGGATGCG-1	Fibroblasts
AGAGATTAGTAAGAAC-1	Endothelial
AGAGATTAGTATCGCG-1	Cardiomyocytes
AGAGGAACAGTTAAAG-1	Endothelial
AGAGGAACATCTAGCA-1	Cardiomyocytes
AGAGGATGTGCACGCA-1	Cardiomyocytes
AGATGAAGTACCAGGT-1	Fibroblasts
AGATGAAGTAGGTTTG-1	Fibroblasts
AGATGAAGTCATTGAG-1	Cardiomyocytes
AGATGAAGTGAGCAAG-1	Cardiomyocytes
AGATGCTTCACTCGCT-1	Endothelial
AGCAAATAGCGGCTGT-1	Fibroblasts
AGCAAATAGGCATTAC-1	Cardiomyocytes
AGCAACAAGCTTAGCG-1	Fibroblasts
AGCAACAAGGTCGATT-1	Endothelial
AGCAACAAGTAAAGGT-1	Cardiomyocytes
AGCAACAAGTTAGCCG-1	Cardiomyocytes
AGCAACAAGTTATGGC-1	Myeloid
AGCAAGGGTGGTGAGA-1	Endothelial
AGCAATTGTTTATTCG-1	Cardiomyocytes
AGCACAGCAAACATAG-1	Cardiomyocytes
AGCACTAGTACGCGCA-1	Fibroblasts
AGCACTAGTGTTGTAG-1	Fibroblasts
AGCACTAGTTATCCGT-1	Cardiomyocytes
AGCACTTAGCATTATG-1	Fibroblasts
AGCAGGTAGTAAGTCC-1	Endothelial
AGCAGGTAGTCAATCA-1	Fibroblasts
AGCATTTCACCTGTAA-1	Endothelial
AGCATTTCAGGCATGA-1	Myeloid
AGCCAGTGTCTAACAG-1	Endothelial
AGCCAGTGTGAGCGAA-1	Cardiomyocytes
AGCCGCTAGCCACAAT-1	Fibroblasts
AGCCGCTAGCCACATG-1	Cardiomyocytes
AGCCTAAGTCGACTCC-1	Pericytes
AGCCTAGTCAGCACCA-1	Fibroblasts
AGCCTCCGTGGGTGAA-1	Smooth.muscle
AGCCTGGGTTCGCGCT-1	Cardiomyocytes
AGCGATTTCACACAGT-1	Fibroblasts
AGCGCCTAGAACAAGT-1	Endothelial
AGCGCCTAGTGAACGA-1	Fibroblasts
AGCGCCTAGTGTTGCG-1	Cardiomyocytes
AGCGCTCAGGCATTGT-1	Cardiomyocytes
AGCGCTCAGTAGCCAT-1	Endothelial
AGCGGACCACACAATT-1	Cardiomyocytes
AGCGGACCATGCAACC-1	Fibroblasts
AGCGGATAGACACTTA-1	Cardiomyocytes
AGCGGATAGCAAGGTA-1	Pericytes
AGCGGATAGCAGGTGG-1	Cardiomyocytes
AGCGGATAGGATCACT-1	Fibroblasts
AGCGGATAGTGAGGGT-1	Fibroblasts
AGCGTGCTCATTACGA-1	Fibroblasts
AGCGTGCTCGATTATG-1	Endothelial
AGCGTGCTCGGCCAGT-1	Endothelial
AGCTAAACAGCTCAAC-1	Fibroblasts
AGCTAACTCCCTGGAA-1	Fibroblasts
AGCTACGTCATGCGTG-1	Fibroblasts
AGCTACGTCCTGGTGA-1	Endothelial
AGCTACTAGAAAGCAT-1	Endothelial
AGCTACTAGCGCCTAA-1	Endothelial
AGCTACTAGCTCATAA-1	Endothelial
AGCTACTAGTAACCAC-1	Cardiomyocytes
AGCTATATCATGGTGT-1	Fibroblasts
AGCTCATAGGAGCACG-1	Pericytes
AGCTCATAGGTGCTGC-1	Myeloid
AGCTTAATCACTAATG-1	Cardiomyocytes
AGCTTAATCGACCTGA-1	Endothelial
AGCTTAATCGTTAAGC-1	Endothelial
AGCTTAATCTAGCTAA-1	Cardiomyocytes
AGCTTAATCTTGACCC-1	Fibroblasts
AGCTTCCTCTTTAAGG-1	Cardiomyocytes
AGCTTTAAGCTCCTTA-1	Endothelial
AGCTTTAAGTAACCCG-1	Cardiomyocytes
AGCTTTAAGTCCTGAG-1	Cardiomyocytes
AGGAAACGTGAGACTC-1	Endothelial
AGGAACCAGGGACGCA-1	Cardiomyocytes
AGGAACCAGTGATTCA-1	Cardiomyocytes
AGGAACCAGTTCCCGT-1	Cardiomyocytes
AGGACGTAGAACCTGT-1	Cardiomyocytes
AGGACGTAGCCAGTAT-1	Cardiomyocytes
AGGACGTAGTTTCCTG-1	Cardiomyocytes
AGGACTAAGACTTACA-1	Cardiomyocytes
AGGACTAAGCACGATT-1	Cardiomyocytes
AGGAGCTAGGTCAAAG-1	Endothelial
AGGATATAGGCTTAGT-1	Cardiomyocytes
AGGATATAGGTGAGAC-1	Endothelial
AGGATGCAGAAAGGAA-1	Cardiomyocytes
AGGATGCAGTAGCGGG-1	Endothelial
AGGATGTCAACCTAAT-1	Endothelial
AGGATTGAGTTGGCCA-1	Fibroblasts
AGGCAATCAGCCAGAA-1	Cardiomyocytes
AGGCAGGTCCTTAGGG-1	Pericytes
AGGCAGGTCGCTTCTA-1	Cardiomyocytes
AGGCCCAGTGCGCGTA-1	Cardiomyocytes
AGGCCCAGTGTTTGAG-1	Endothelial
AGGCGGATCACTTTAC-1	Fibroblasts
AGGCGGATCCATAAGC-1	Fibroblasts
AGGCTAAAGAGGAGTC-1	Cardiomyocytes
AGGCTAAAGCTCATAA-1	Cardiomyocytes
AGGCTAAAGGAGTCTT-1	Cardiomyocytes
AGGCTAAAGGTGCGGA-1	Cardiomyocytes
AGGCTAGCAGTGAACG-1	Cardiomyocytes
AGGCTAGCATGATTGT-1	Endothelial
AGGGTTGCAAGCTTTG-1	Cardiomyocytes
AGGGTTGCAATAGCCC-1	Fibroblasts
AGGGTTGCAGGCGAGT-1	Cardiomyocytes
AGGTCAAAGTAACGAG-1	Fibroblasts
AGGTCATTCACCTGTC-1	Endothelial
AGGTCATTCCGCAACA-1	Cardiomyocytes
AGGTCATTCGCCTAAG-1	Cardiomyocytes
AGGTCCGGTCGTTATC-1	Cardiomyocytes
AGGTCCGGTGGACATC-1	Cardiomyocytes
AGGTCCGGTTTACTTG-1	Endothelial
AGGTCTTAGGACTTAC-1	Fibroblasts
AGGTCTTAGGCGAAAC-1	Cardiomyocytes
AGGTCTTAGGGTGAGT-1	Cardiomyocytes
AGGTGAATCACAGCGC-1	Fibroblasts
AGGTGAATCCCGTTTA-1	Fibroblasts
AGGTGAATCCTTAATC-1	Fibroblasts
AGGTGAATCGGTTCCT-1	Cardiomyocytes
AGGTGAGGTGGATGTC-1	Cardiomyocytes
AGGTGAGGTGTTGCTT-1	Endothelial
AGGTTAACACCTACTT-1	Fibroblasts
AGGTTACTCTCACTCA-1	Cardiomyocytes
AGGTTAGAGGATAAAC-1	Endothelial
AGGTTAGAGTACCGCA-1	Cardiomyocytes
AGGTTTGGTTTCCGGC-1	Cardiomyocytes
AGTAAACAGGCTATGT-1	Fibroblasts
AGTAAACAGGTACCGC-1	Adipocytes
AGTAACACAATAACGA-1	Cardiomyocytes
AGTAACGAGTTTGTCT-1	Cardiomyocytes
AGTAAGTAGCGATAGA-1	Cardiomyocytes
AGTACGCGTGACATAT-1	Endothelial
AGTAGCTTCATGCGTG-1	Cardiomyocytes
AGTAGGATCTATGACA-1	Cardiomyocytes
AGTCAAGAGCTATATG-1	Cardiomyocytes
AGTCAAGAGTAGGCGG-1	Fibroblasts
AGTCAAGAGTTAGTGC-1	Cardiomyocytes
AGTCAATGTTAGAGGG-1	Fibroblasts
AGTCAGGCATAATCAC-1	Cardiomyocytes
AGTCCTGAGAAACTGG-1	Pericytes
AGTCCTGAGCCATCAG-1	Cardiomyocytes
AGTCCTGAGGAACCGG-1	Smooth.muscle
AGTCCTTGTACTGAAT-1	Cardiomyocytes
AGTCCTTGTATGGTGC-1	Fibroblasts
AGTCCTTGTGGTTATG-1	Cardiomyocytes
AGTCCTTGTTCCGCAC-1	Cardiomyocytes
AGTCCTTGTTTATCGC-1	Cardiomyocytes
AGTCGCATCATTACTC-1	Fibroblasts
AGTCTTGCACCAAAGG-1	Cardiomyocytes
AGTGAGTCAAAGCTCC-1	Pericytes
AGTGAGTCAGAAATGC-1	Myeloid
AGTGATGAGATAACCC-1	Cardiomyocytes
AGTGATGAGCACGATT-1	Cardiomyocytes
AGTGCACGTTGAGGTC-1	Cardiomyocytes
AGTGCACGTTGGCCGA-1	Endothelial
AGTGCCGGTGTCACGG-1	Fibroblasts
AGTGGACAGGCTACAT-1	Cardiomyocytes
AGTGTGGCATTGCGAC-1	Cardiomyocytes
AGTGTTTCACAAAGAC-1	Endothelial
AGTTACATCTCACATT-1	Fibroblasts
AGTTACTCATTGCAGC-1	Cardiomyocytes
AGTTATGTCTCCTCAA-1	Cardiomyocytes
AGTTGCAGTGCTCCGT-1	Cardiomyocytes
AGTTGCGTCAAACACC-1	Fibroblasts
AGTTGGCGTGAAACAA-1	Cardiomyocytes
AGTTGGCGTTGCGGAT-1	Endothelial
AGTTTGATCCAAGTTA-1	Cardiomyocytes
AGTTTGCAGAGCAAGC-1	Fibroblasts
ATAAGCCTCACTAAGC-1	Cardiomyocytes
ATAAGCCTCGCTAGAT-1	Cardiomyocytes
ATAAGCCTCGTTACTT-1	Fibroblasts
ATAATGGCAGCTACGT-1	Cardiomyocytes
ATAATGGCATGATTGT-1	Cardiomyocytes
ATACCTGCATGACTAT-1	Cardiomyocytes
ATAGATGCATGAAATG-1	Endothelial
ATAGCATGTACCGGAT-1	Endothelial
ATATAGGCACCTCGCT-1	Fibroblasts
ATATAGGCAGGATAAC-1	Cardiomyocytes
ATATGCATCACAGACT-1	Cardiomyocytes
ATATGCATCCTAAATG-1	Pericytes
ATATGCATCCTGAATA-1	Pericytes
ATATGGTGTTTAGCTC-1	Cardiomyocytes
ATCAAGACAGTACCGT-1	Pericytes
ATCAAGACATAATCCG-1	Cardiomyocytes
ATCAAGACATTGCGAC-1	Cardiomyocytes
ATCAAGCTCTTAGTGA-1	Fibroblasts
ATCAATCCACTTCACT-1	Endothelial
ATCACAATCGCTAGAT-1	Endothelial
ATCACAATCGGTTTCC-1	Fibroblasts
ATCACACAGAATCTCA-1	Cardiomyocytes
ATCACACAGCTATGAC-1	Neuronal
ATCACACAGGCGTAAA-1	Fibroblasts
ATCACCCTCCGCAAAT-1	Endothelial
ATCACCCTCTAACCAA-1	Cardiomyocytes
ATCACCCTCTTTGAGA-1	Fibroblasts
ATCACTAAGACAACAG-1	Fibroblasts
ATCACTAAGGCATTAC-1	Cardiomyocytes
ATCACTAAGTGTTGCG-1	Fibroblasts
ATCACTAAGTTCCTCA-1	Fibroblasts
ATCAGGTTCATTACTC-1	Cardiomyocytes
ATCAGGTTCCTGAATA-1	Cardiomyocytes
ATCATGTCATGTTGCA-1	Cardiomyocytes
ATCCAACAGCCGGTAC-1	Cardiomyocytes
ATCCACCTCCAAGTGT-1	Cardiomyocytes
ATCCACCTCCTTAATC-1	Pericytes
ATCCATAAGCATGTCG-1	Fibroblasts
ATCCATAAGGCGGGTA-1	Cardiomyocytes
ATCCGTGAGAAACTGG-1	Fibroblasts
ATCCGTGAGCGATACT-1	Cardiomyocytes
ATCCGTGAGGTCAAAG-1	Endothelial
ATCCGTGAGGTGTTAC-1	Cardiomyocytes
ATCCGTGAGGTTTACA-1	Cardiomyocytes
ATCCGTGAGTAGCCAT-1	Fibroblasts
ATCCTCATCATTGTTC-1	Fibroblasts
ATCCTGACAGGCCATT-1	Cardiomyocytes
ATCCTTAGTGTTGTGA-1	Fibroblasts
ATCCTTAGTTTGCTGT-1	Cardiomyocytes
ATCGAGGCACTGACCG-1	Fibroblasts
ATCGAGGCATGCATAT-1	Endothelial
ATCGCCCGTCGTAATG-1	Cardiomyocytes
ATCGCCCGTGTTAAAC-1	Endothelial
ATCGGCCAGAGGAGGA-1	Cardiomyocytes
ATCGGCCAGAGGGACT-1	Cardiomyocytes
ATCGGCCAGTGAGCAA-1	Cardiomyocytes
ATCTTTGGTATGTGGC-1	Cardiomyocytes
ATCTTTGGTGAGGTAG-1	Cardiomyocytes
ATCTTTGGTTATCCGT-1	Endothelial
ATGAAGCCAAGGTCCT-1	Cardiomyocytes
ATGAAGCCAATTAAGG-1	Cardiomyocytes
ATGAAGTAGACTCGCA-1	Pericytes
ATGAATGCATAAAGCA-1	Endothelial
ATGACAACACAGAAAC-1	Endothelial
ATGACCAGTGTTCCCA-1	Cardiomyocytes
ATGACCAGTTAAATGC-1	Endothelial
ATGACGAAGGCATGTT-1	Endothelial
ATGAGCCGTCAAAGGG-1	Endothelial
ATGATGGAGAACCTAC-1	Fibroblasts
ATGATGGAGGGTGGAT-1	Cardiomyocytes
ATGCAAACAGGCTAGA-1	Pericytes
ATGCAGGCACGTAAGG-1	Cardiomyocytes
ATGCATTCACAAGCCT-1	Endothelial
ATGCCTGAGTTGGGCC-1	Cardiomyocytes
ATGCGATTCAATGTCA-1	Cardiomyocytes
ATGCGATTCCAACTGG-1	Endothelial
ATGCGATTCGGTCAAT-1	Cardiomyocytes
ATGCTTAAGACAAGTG-1	Cardiomyocytes
ATGCTTAAGCCGCTTT-1	Pericytes
ATGCTTAAGGACTTAC-1	Cardiomyocytes
ATGGACAAGAATCTCA-1	Cardiomyocytes
ATGGACAAGCTAATTG-1	Cardiomyocytes
ATGGCCCAGCTGTAAC-1	Fibroblasts
ATGGCCCAGGCGGGTA-1	Cardiomyocytes
ATGGCCGGTCATCCTG-1	Cardiomyocytes
ATGGCTAGTAGCTAGC-1	Myeloid
ATGGCTAGTCACAAAT-1	Fibroblasts
ATGGCTAGTCAGGAAG-1	Cardiomyocytes
ATGGCTGTCCCTCATA-1	Cardiomyocytes
ATGGTCTAGAATCTCA-1	Cardiomyocytes
ATGGTCTAGATAGACG-1	Endothelial
ATGGTCTAGCCGCTAA-1	Endothelial
ATGGTCTAGGCGCTAC-1	Cardiomyocytes
ATGGTTATCACTCAAA-1	Cardiomyocytes
ATGGTTATCGTAACGT-1	Fibroblasts
ATGTAACGTGTCCAGG-1	Cardiomyocytes
ATGTAAGCAATAGCCC-1	Cardiomyocytes
ATGTAAGCATTGTGGC-1	Fibroblasts
ATGTCAATCATTAGGC-1	Cardiomyocytes
ATGTCATCAGCCAGAA-1	Cardiomyocytes
ATGTCCACACCGGTAT-1	Endothelial
ATGTGAGAGCCAGTAT-1	Cardiomyocytes
ATGTGAGAGCTCGCTT-1	Cardiomyocytes
ATGTTCAAGCAAGGTA-1	Endothelial
ATGTTCAAGCCAGTAT-1	Endothelial
ATGTTCAAGTTATTCC-1	Cardiomyocytes
ATGTTGTCACAGCCTG-1	Fibroblasts
ATGTTTGAGGCCAATT-1	Cardiomyocytes
ATTAACCCACCTAAGC-1	Fibroblasts
ATTACCCGTGGTTCTT-1	Cardiomyocytes
ATTACCGCATTGTGGC-1	Fibroblasts
ATTACGTCAATCCTAG-1	Endothelial
ATTACGTCACCAGCAT-1	Fibroblasts
ATTACGTCATCCCGCT-1	Endothelial
ATTACGTCATGAGTTT-1	Fibroblasts
ATTACGTCATGGCCTG-1	Fibroblasts
ATTACTGAGACTCGCA-1	Cardiomyocytes
ATTACTGAGCTAATCA-1	Fibroblasts
ATTACTGAGGCTGTGC-1	Cardiomyocytes
ATTAGCTCAAGGAATC-1	Cardiomyocytes
ATTAGCTCAATTGCGC-1	Fibroblasts
ATTAGGTGTAACGGGA-1	Cardiomyocytes
ATTAGTCCACCGGCTA-1	Endothelial
ATTAGTCCATCACAGC-1	Fibroblasts
ATTATCCTCCCTCTAA-1	Endothelial
ATTATGGTCCCGAAGC-1	Fibroblasts
ATTATGGTCTAAATCG-1	Cardiomyocytes
ATTCAACCAATGCGCT-1	Cardiomyocytes
ATTCATGAGCTGAGGG-1	Endothelial
ATTCATGAGTTTGTCT-1	Fibroblasts
ATTCCTAGTCGTTATC-1	Cardiomyocytes
ATTCCTCCACTCGCTC-1	Pericytes
ATTCGTTTCACAGGAA-1	Endothelial
ATTGAAGCACTAGGTC-1	Endothelial
ATTGACTCAAACTGTT-1	Fibroblasts
ATTGACTCATTAGCCA-1	Fibroblasts
ATTGCACAGAGAGGAG-1	Cardiomyocytes
ATTGCACAGCCAGGTC-1	Pericytes
ATTGCACAGCTGAGGG-1	Endothelial
ATTGCAGGTACCGTTT-1	Fibroblasts
ATTGCGCCACCTGTAA-1	Cardiomyocytes
ATTGCGCCATGGCCCA-1	Endothelial
ATTGCTCGTGCTCCAC-1	Fibroblasts
ATTGGCTAGCCTGAGC-1	Cardiomyocytes
ATTGGCTAGGACCTGC-1	Endothelial
ATTGGCTAGGGTTAGA-1	Cardiomyocytes
ATTGGCTAGTTGGCCA-1	Smooth.muscle
ATTTAGCCAAGACTCC-1	Fibroblasts
ATTTAGGTCATGCATA-1	Endothelial
ATTTAGGTCTTGCATT-1	Endothelial
ATTTGCAAGTCGCAAT-1	Cardiomyocytes
ATTTGCGCAGAATGAC-1	Cardiomyocytes
ATTTGCGCATGTGGGA-1	Fibroblasts
ATTTGTGAGAACCTGT-1	Cardiomyocytes
ATTTGTGAGCAGCTCA-1	Cardiomyocytes
ATTTGTGAGGACCTGC-1	Cardiomyocytes
ATTTGTGAGGCCTAAT-1	Cardiomyocytes
ATTTGTGAGTAGCGCC-1	Fibroblasts
CAAACAACAGGGAGCT-1	Fibroblasts
CAAACATGTAGCCATA-1	Cardiomyocytes
CAAACATGTCAAGACC-1	Myeloid
CAAACATGTGGATGTC-1	Fibroblasts
CAAACATGTTTGGTTC-1	Cardiomyocytes
CAAACCGTCTATGACA-1	Adipocytes
CAAAGCGCATTATGGT-1	Endothelial
CAAAGGATCCCATAAA-1	Endothelial
CAAAGGATCCCGCCTA-1	Endothelial
CAAAGGATCCCTGTTA-1	Endothelial
CAAAGGATCGGCTATG-1	Cardiomyocytes
CAAATCATCAGCAAGA-1	Pericytes
CAAATCATCTTGCAGG-1	Cardiomyocytes
CAACAATGTCCTCCAA-1	Cardiomyocytes
CAACAATGTGTCCAGG-1	Cardiomyocytes
CAACAGGCACAGGATG-1	Cardiomyocytes
CAACCCGCAGTTAGCC-1	Cardiomyocytes
CAACCCGCATAATGAG-1	Fibroblasts
CAACCCGCATCCGTAA-1	Fibroblasts
CAACTAATCCTAAGTA-1	Endothelial
CAACTAGGTCATAGAT-1	Endothelial
CAACTAGGTGATGAGG-1	Cardiomyocytes
CAAGACAAGCACAGAA-1	Pericytes
CAAGACAAGGTTACAC-1	Endothelial
CAAGACAAGTAAACCC-1	Cardiomyocytes
CAAGACAAGTTAACCA-1	Cardiomyocytes
CAAGACAAGTTAGCCG-1	Cardiomyocytes
CAAGACAAGTTAGGCT-1	Neuronal
CAAGGCTGTACTTCAC-1	Fibroblasts
CAAGGCTGTTATCCGT-1	Cardiomyocytes
CAAGGGAGTAGGATCC-1	Fibroblasts
CAAGGGAGTAGGTTTG-1	Fibroblasts
CAAGGGAGTTGCATCT-1	Cardiomyocytes
CAAGGTAAGCACCACA-1	Endothelial
CAAGGTTTCAACAAGG-1	Fibroblasts
CAAGGTTTCATTAGTG-1	Fibroblasts
CAAGGTTTCTGGCATG-1	Cardiomyocytes
CAAGTAACAAGGTACG-1	Fibroblasts
CAAGTAACACCAGCAT-1	Adipocytes
CAAGTAACAGTGAACG-1	Pericytes
CAAGTATGTGCATCGG-1	Adipocytes
CAAGTGAAGCGCTAAT-1	Adipocytes
CAAGTGAAGTCACCAG-1	Fibroblasts
CAAGTTATCTAGCGTG-1	Endothelial
CAAGTTATCTCACAAA-1	Pericytes
CAATAAGCAATCATGT-1	Pericytes
CAATAAGCACTAAGCC-1	Neuronal
CAATAAGCATTGTGGC-1	Pericytes
CAATAGCTCAAGTGTC-1	Cardiomyocytes
CAATAGCTCCATAATG-1	Cardiomyocytes
CAATAGCTCTAAATCG-1	Endothelial
CAATAGCTCTACTAAG-1	Endothelial
CAATATGTCCCGCATT-1	Endothelial
CAATATGTCCGGTTGA-1	Cardiomyocytes
CAATATGTCGGCTAGC-1	Fibroblasts
CAATATGTCGTTAGCG-1	Endothelial
CAATATGTCTCGCCCA-1	Cardiomyocytes
CAATCCCTCACAAGCT-1	Cardiomyocytes
CAATCCCTCCAAGTGT-1	Cardiomyocytes
CAATCCTGTTAATGAC-1	Cardiomyocytes
CAATCCTGTTACTTGC-1	Smooth.muscle
CAATCGCCACAGACTC-1	Cardiomyocytes
CAATCGCCAGCAATAA-1	Adipocytes
CAATCTAAGCCTAACG-1	Endothelial
CAATGAACAAAGCGCA-1	Fibroblasts
CAATGCCCAATTAACC-1	Fibroblasts
CAATGCCCACAGGATG-1	Fibroblasts
CAATGCCCATCCTAGA-1	Cardiomyocytes
CAATGTCAGGAGGCAT-1	Fibroblasts
CAATGTGGTATTGTCC-1	Cardiomyocytes
CAATGTGGTCAGGAAG-1	Cardiomyocytes
CAATGTGGTCATTACC-1	Cardiomyocytes
CAATGTGGTGACATGC-1	Endothelial
CAATGTGGTGTCACGG-1	Endothelial
CAATGTGGTTGAATCG-1	Endothelial
CAATGTGGTTTGTGGA-1	Adipocytes
CACAAGCGTGATCATG-1	Cardiomyocytes
CACAAGCGTGATGAGG-1	Endothelial
CACAAGCGTTTGTTGC-1	Cardiomyocytes
CACAGGCTCAAGTGTC-1	Cardiomyocytes
CACAGGCTCCTGATGG-1	Cardiomyocytes
CACAGGGAGGGACTAA-1	Cardiomyocytes
CACAGGGAGTATTGGC-1	Fibroblasts
CACATAATCCCATAAA-1	Cardiomyocytes
CACATACAGTTACCGG-1	Endothelial
CACATTAAGCTTGCTC-1	Cardiomyocytes
CACATTAAGGCTAATC-1	Cardiomyocytes
CACATTAAGGTTTACA-1	Endothelial
CACATTAAGTTCCTCA-1	Fibroblasts
CACCAACCAAGTGAAC-1	Cardiomyocytes
CACCAACCACAATTAC-1	Smooth.muscle
CACCGGTAGGGCTTTG-1	Fibroblasts
CACCGGTAGGTCCGTA-1	Endothelial
CACCGGTAGGTCGAGG-1	Endothelial
CACCTCAGTCAAGTAT-1	Fibroblasts
CACCTGTTCAAGGACA-1	Endothelial
CACCTGTTCCTAAGGT-1	Pericytes
CACCTGTTCGAAGTAG-1	Fibroblasts
CACCTGTTCTCAATAG-1	Cardiomyocytes
CACCTGTTCTGCAAGT-1	Fibroblasts
CACGCTAAGGTGTTAC-1	Endothelial
CACTAGCCAACTCGCG-1	Cardiomyocytes
CACTAGCCACAGACTC-1	Pericytes
CACTAGCCATGCTTAG-1	Cardiomyocytes
CACTGACCAAAGGTAC-1	Cardiomyocytes
CACTGACCAGCCGCTA-1	Cardiomyocytes
CACTTAAAGGGCTTAT-1	Fibroblasts
CACTTAAAGGTGTCCA-1	Endothelial
CACTTAAAGTATTGTG-1	Adipocytes
CACTTTGTCCATTACT-1	Endothelial
CACTTTGTCTGGTCCT-1	Fibroblasts
CAGAACCGTCATTACC-1	Fibroblasts
CAGAATCTCACCTGTC-1	Endothelial
CAGAATCTCATGCGTG-1	Cardiomyocytes
CAGAATCTCCCTCAAC-1	Smooth.muscle
CAGATTCAGGTTTACA-1	Fibroblasts
CAGCAAGCAGGCTTCG-1	Cardiomyocytes
CAGCAAGCAGGGAGCT-1	Fibroblasts
CAGCAAGCATCAATCG-1	Fibroblasts
CAGCATGTCAATCTAG-1	Smooth.muscle
CAGCATGTCCTTAAGA-1	Myeloid
CAGCATGTCGTGCTAG-1	Cardiomyocytes
CAGCATGTCTTGCAAA-1	Cardiomyocytes
CAGCATTAGATTCCTT-1	Pericytes
CAGCCAATCGTTATCT-1	Cardiomyocytes
CAGCCTAAGCGATAAG-1	Endothelial
CAGCCTAAGCGGCTGT-1	Cardiomyocytes
CAGCTAAGTAGGTTAT-1	Smooth.muscle
CAGCTAAGTGAGCAAG-1	Endothelial
CAGCTAAGTTCGCTTG-1	Cardiomyocytes
CAGCTAAGTTCTTTAG-1	Cardiomyocytes
CAGGAAGGTTACTAGG-1	Endothelial
CAGGACACAATATACC-1	Cardiomyocytes
CAGGACACACCTACTT-1	Cardiomyocytes
CAGGACCTCAGCTAAC-1	Cardiomyocytes
CAGGATGCAACTGGCT-1	Endothelial
CAGGATGCATTGTGCA-1	Cardiomyocytes
CAGGCTATCATAATCG-1	Cardiomyocytes
CAGGCTATCCCGCAAA-1	Cardiomyocytes
CAGGCTATCTCACATT-1	Endothelial
CAGGCTGGTGAAACAA-1	Cardiomyocytes
CAGGCTGGTGCAATGC-1	Fibroblasts
CAGGGCTTCATGCTTT-1	Endothelial
CAGGGTGAGCAACAAG-1	Fibroblasts
CAGGTCCAGCGAGCGA-1	Endothelial
CAGGTCCAGGCCTTAG-1	Cardiomyocytes
CAGGTGGAGGATGATG-1	Fibroblasts
CAGGTGGAGTTTGGGT-1	Endothelial
CAGGTTAGTTAATGCG-1	Cardiomyocytes
CAGGTTTAGCTATTGA-1	Pericytes
CAGGTTTAGGTCCAAT-1	Fibroblasts
CAGTACCCACCTACTT-1	Endothelial
CATAAGCTCGTTAAGC-1	Cardiomyocytes
CATAATCCACCCACAG-1	Pericytes
CATAATCCACCTATAG-1	Fibroblasts
CATAATGTCATCCTCA-1	Endothelial
CATAATGTCCTTAGGG-1	Cardiomyocytes
CATAGACTCCGTAAAC-1	Cardiomyocytes
CATAGCTAGTCAGGCC-1	Cardiomyocytes
CATAGGCGTAGTTGGC-1	Cardiomyocytes
CATAGGCGTTGTAACG-1	Fibroblasts
CATAGGTTCAGTATTG-1	Fibroblasts
CATAGTCAGGCGCACT-1	Cardiomyocytes
CATAGTCAGGTAAGCA-1	Cardiomyocytes
CATAGTCAGTAACTCA-1	Cardiomyocytes
CATAGTCAGTTCCTGC-1	Cardiomyocytes
CATAGTCAGTTGTCAA-1	Myeloid
CATATCGCAAAGCTAA-1	Cardiomyocytes
CATCAATCATGCTCCC-1	Cardiomyocytes
CATCACACAAGTAAGC-1	Cardiomyocytes
CATCACACAGGCTTCG-1	Endothelial
CATCACACATTAGGCC-1	Pericytes
CATCATAAGCGCAATT-1	Cardiomyocytes
CATCATAAGGGTGAGT-1	Fibroblasts
CATCATGCACGTAATT-1	Endothelial
CATCATGCACTGGCCA-1	Cardiomyocytes
CATCCTGGTATGTGGC-1	Cardiomyocytes
CATCCTGGTTTGAGGC-1	Pericytes
CATCGCTTCTAAGGAG-1	Endothelial
CATCGCTTCTTGTTCG-1	Myeloid
CATGAGGCAACTAGAA-1	Smooth.muscle
CATGAGGCAGCACCAT-1	Cardiomyocytes
CATGAGGCAGTAATAG-1	Fibroblasts
CATGAGGCATGCTTAG-1	Cardiomyocytes
CATGCAAGTCACTCGC-1	Cardiomyocytes
CATGCATAGCACTAAC-1	Endothelial
CATGCATAGCTTGCTC-1	Cardiomyocytes
CATGCGCAGGGCTTTG-1	Fibroblasts
CATGCGCAGGTTTGAC-1	Fibroblasts
CATGCGGGTTGTAAAC-1	Fibroblasts
CATGCGGGTTTATTCG-1	Fibroblasts
CATGGATTCACAGCCA-1	Endothelial
CATGGATTCGTACCGA-1	Cardiomyocytes
CATTATCTCTAAGTGC-1	Smooth.muscle
CATTATGAGACTCGCA-1	Cardiomyocytes
CATTATGAGATGGACA-1	Pericytes
CATTATGAGCCAGGTC-1	Pericytes
CATTATGAGGAAGCTA-1	Fibroblasts
CATTATGAGTCAATCA-1	Fibroblasts
CATTCATTCATAACTG-1	Cardiomyocytes
CATTCATTCCCTCAAC-1	Endothelial
CATTCATTCCTCACAC-1	Cardiomyocytes
CATTCCTCATAATGAG-1	Cardiomyocytes
CATTCCTCATGTTGTG-1	Endothelial
CATTCCTCATTAAGTC-1	Fibroblasts
CATTGCGAGCCGCAAC-1	Fibroblasts
CATTGTAAGCAAGGAC-1	Endothelial
CATTGTAAGTCAGTAC-1	Fibroblasts
CATTGTGCAAACTCAT-1	Fibroblasts
CATTTGTTCACAGCCA-1	Endothelial
CATTTGTTCAGCATTA-1	Endothelial
CATTTGTTCCCTCTAA-1	Fibroblasts
CATTTGTTCTAATCCT-1	Cardiomyocytes
CCAAACTAGCGAAGTA-1	Fibroblasts
CCAAACTAGTGAGGGT-1	Fibroblasts
CCAAATCAGCCTGACA-1	Pericytes
CCAACCCGTTCGCTCA-1	Pericytes
CCAAGGCTCGGGCCAT-1	Cardiomyocytes
CCAAGTTAGAATCGCT-1	Fibroblasts
CCAAGTTAGCTTTGTT-1	Cardiomyocytes
CCAAGTTAGGAGGCAT-1	Fibroblasts
CCAAGTTAGGCTAATC-1	Smooth.muscle
CCAATATCAGAATGAC-1	Pericytes
CCACAATAGCTATTAG-1	Fibroblasts
CCACAATAGGTCGATT-1	Cardiomyocytes
CCACAATAGTAACAGG-1	Cardiomyocytes
CCACACAAGTAAAGGT-1	Fibroblasts
CCACAGGGTTCAAGCA-1	Myeloid
CCACATTGTCCTAAGA-1	Endothelial
CCACATTGTGATGATT-1	Cardiomyocytes
CCACATTGTTTGAGCA-1	Endothelial
CCAGACTCAATTGAGA-1	Cardiomyocytes
CCAGCCTGTCATGAGC-1	Fibroblasts
CCAGCTAAGACAGGCG-1	Cardiomyocytes
CCAGCTAAGCCTCTCG-1	Cardiomyocytes
CCAGCTGCAAGATTCT-1	Fibroblasts
CCAGGAACAAGATTCT-1	Cardiomyocytes
CCAGGAACAAGCGATG-1	Fibroblasts
CCAGGAACAAGTCGCT-1	Fibroblasts
CCAGGAACATAGCAGG-1	Endothelial
CCAGGAACATATTGAC-1	Cardiomyocytes
CCAGGATGTGCGCGTA-1	Cardiomyocytes
CCAGTTTGTTCCTGTG-1	Endothelial
CCATAAATCAGCAAAG-1	Pericytes
CCATAAGGTGTTCCCA-1	Endothelial
CCATAAGGTTAACACG-1	Endothelial
CCATAATCAAGGTAAC-1	Neuronal
CCATAATCAGGACACA-1	Fibroblasts
CCATAGCCACTAAGAA-1	Cardiomyocytes
CCATATTTCAAGACTC-1	Endothelial
CCATATTTCCAGGTCA-1	Cardiomyocytes
CCATCACTCATCCTCA-1	Endothelial
CCATCATGTGTAATAC-1	Endothelial
CCATTATTCGGTCATG-1	Fibroblasts
CCATTGTGTTTATTCG-1	Cardiomyocytes
CCCAAACCAGATTCAT-1	Endothelial
CCCAAACCATAAACCT-1	Endothelial
CCCAAATAGCGGATAA-1	Cardiomyocytes
CCCAAATAGCTTAACA-1	Cardiomyocytes
CCCAAATAGCTTCTCA-1	Cardiomyocytes
CCCAAATAGTAGAGGC-1	Cardiomyocytes
CCCAACCGTCATCCTG-1	Cardiomyocytes
CCCAACCGTGACCTGG-1	Endothelial
CCCAACCGTGCGCAAT-1	Cardiomyocytes
CCCAACCGTGCTTAGA-1	Fibroblasts
CCCAACCGTTACGCAA-1	Cardiomyocytes
CCCAACCGTTGTAACG-1	Endothelial
CCCAATTGTTTCCACG-1	Cardiomyocytes
CCCAGCACACCTCGCT-1	Cardiomyocytes
CCCAGCACAGTTTGTG-1	Endothelial
CCCAGCACATACCCGG-1	Cardiomyocytes
CCCAGTTTCAAGTGTC-1	Adipocytes
CCCAGTTTCAGCATTA-1	Cardiomyocytes
CCCGCAACAATTAGGA-1	Endothelial
CCCGCAACAGTTAAAG-1	Pericytes
CCCGCAACAGTTTGGC-1	Pericytes
CCCGCTTCATCAGTAT-1	Fibroblasts
CCCGTAAAGACCATAC-1	Cardiomyocytes
CCCGTAAAGGAAGTAT-1	Cardiomyocytes
CCCGTAAAGGTAAGGC-1	Cardiomyocytes
CCCGTAAAGTGTGATC-1	Fibroblasts
CCCGTTGTCCGCAAAT-1	Fibroblasts
CCCGTTGTCCGCAAGC-1	Fibroblasts
CCCGTTGTCGTTCACC-1	Cardiomyocytes
CCCTAATGTCGACTAA-1	Endothelial
CCCTCACCAATGAAGC-1	Pericytes
CCCTCAGTCGGGACTC-1	Cardiomyocytes
CCCTCATAGCCACAAT-1	Cardiomyocytes
CCCTCATAGCTTATGA-1	Fibroblasts
CCCTCATAGGCCTGGT-1	Pericytes
CCCTTAATCTCAATTC-1	Cardiomyocytes
CCGACAGGTCTTGCAT-1	Cardiomyocytes
CCGACAGGTGGAAGGC-1	Endothelial
CCGATGCAGCCTGTGA-1	Endothelial
CCGCAAATCAATAGCC-1	Fibroblasts
CCGCAAATCAGGGCCT-1	Fibroblasts
CCGCAAATCCGCATGA-1	Cardiomyocytes
CCGCAAATCTTACTCG-1	Cardiomyocytes
CCGCACACAACTAGAA-1	Fibroblasts
CCGCACACACATTGCA-1	Cardiomyocytes
CCGCACACACTAGGTC-1	Cardiomyocytes
CCGCCAACACCTCACC-1	Pericytes
CCGCCAACAGTGAACG-1	Smooth.muscle
CCGCTAAAGGCTAAGA-1	Cardiomyocytes
CCGCTAAAGTATCGCG-1	Cardiomyocytes
CCGCTAGCAGTTTGTG-1	Fibroblasts
CCGCTTAGTACGGTAC-1	Cardiomyocytes
CCGCTTAGTATTCGTC-1	Fibroblasts
CCGCTTAGTCAGGCAT-1	Fibroblasts
CCGCTTAGTGGTGAGA-1	Smooth.muscle
CCGGTAGGTAGCCTCC-1	Endothelial
CCGGTAGGTCATAGAT-1	Cardiomyocytes
CCGGTAGGTCCCGAAG-1	Pericytes
CCGGTTAAGGTTACAC-1	Smooth.muscle
CCGGTTAAGTCAGTAC-1	Cardiomyocytes
CCGTGCTGTCATGAGC-1	Cardiomyocytes
CCGTGCTGTCGACTAA-1	Cardiomyocytes
CCGTGCTGTGAAACAA-1	Cardiomyocytes
CCGTGCTGTGGTTATG-1	Fibroblasts
CCGTTACTCATCCTGC-1	Fibroblasts
CCGTTACTCATGCGTG-1	Fibroblasts
CCGTTACTCCACCCTG-1	Endothelial
CCGTTATGTGAGCAAG-1	Fibroblasts
CCGTTATGTTCACTGT-1	Fibroblasts
CCGTTGCGTAATAGCT-1	Cardiomyocytes
CCGTTGCGTACTGATG-1	Neuronal
CCGTTGCGTGCGCGTA-1	Cardiomyocytes
CCGTTGCGTTAGTGAT-1	Pericytes
CCGTTTGGTACTTCAC-1	Cardiomyocytes
CCTAAGCCAAAGGCCA-1	Cardiomyocytes
CCTAAGTAGCGTGCGT-1	Endothelial
CCTAAGTAGTCACTCC-1	Pericytes
CCTAATAAGACAAACG-1	Fibroblasts
CCTAATAAGTCGCTAG-1	Cardiomyocytes
CCTAATAAGTGAGCGG-1	Endothelial
CCTAATAAGTTGGATC-1	Cardiomyocytes
CCTAATAAGTTTCCTG-1	Cardiomyocytes
CCTACTGGTGTTGTAG-1	Endothelial
CCTACTTCAGCTTACA-1	Smooth.muscle
CCTAGTTGTTGGTTCT-1	Endothelial
CCTAGTTGTTTGGGCG-1	Endothelial
CCTATATTCCTTGAGG-1	Cardiomyocytes
CCTATATTCGCTCACT-1	Cardiomyocytes
CCTATTTAGGTTTGCG-1	Endothelial
CCTCAAACAATTTGGT-1	Cardiomyocytes
CCTCAAACATTGGGAG-1	Cardiomyocytes
CCTCAATGTAAACAAG-1	Fibroblasts
CCTCAGTTCATGACCG-1	Cardiomyocytes
CCTCCTCTCCTTCGTA-1	Cardiomyocytes
CCTCCTCTCTCCATAT-1	Cardiomyocytes
CCTGAATAGGCTGTGC-1	Cardiomyocytes
CCTGACTTCCCAGTAG-1	Pericytes
CCTGATGAGTAGCGGG-1	Cardiomyocytes
CCTGATGAGTAGGCGG-1	Endothelial
CCTGATGAGTCACCTC-1	Smooth.muscle
CCTGGTAAGCCAAATC-1	Fibroblasts
CCTGGTAAGGCCTTAG-1	Fibroblasts
CCTGTATGTATTTGGG-1	Endothelial
CCTGTATGTTGGATCA-1	Cardiomyocytes
CCTGTATGTTTGCAGA-1	Fibroblasts
CCTGTTGGTAACCACA-1	Myeloid
CCTGTTGGTCACACCC-1	Cardiomyocytes
CCTTAACGTGATGGCT-1	Cardiomyocytes
CCTTAACGTTCGGTAA-1	Myeloid
CCTTACTCAGTTAAAG-1	Fibroblasts
CCTTAGTGTGGTTCCC-1	Cardiomyocytes
CCTTATGTCCAATAGC-1	Cardiomyocytes
CCTTATGTCCAGGTCA-1	Fibroblasts
CCTTATGTCCTAATGA-1	Fibroblasts
CCTTATGTCGCAATCG-1	Neuronal
CCTTCAATCCTGGTCT-1	Cardiomyocytes
CCTTCAATCTTTGAGA-1	Cardiomyocytes
CCTTCAGGTAAGGTTT-1	Endothelial
CCTTCAGGTCAAACTG-1	Cardiomyocytes
CCTTCAGGTTTAAAGC-1	Cardiomyocytes
CCTTCGGTCATGCGTG-1	Fibroblasts
CCTTCGTAGTTGTCAA-1	Pericytes
CCTTGCGTCCTAATAG-1	Cardiomyocytes
CCTTGTTCAATATAGG-1	Smooth.muscle
CCTTGTTCAGTTGCGT-1	Smooth.muscle
CCTTGTTCATAACGGG-1	Cardiomyocytes
CCTTTAGTCCGCCTCA-1	Cardiomyocytes
CGAAATGAGCGCATTG-1	Fibroblasts
CGAACAAAGGAAGCTA-1	Smooth.muscle
CGAACAAAGTTGTCAA-1	Cardiomyocytes
CGAACCGGTCTTTGAC-1	Cardiomyocytes
CGAACCGGTTGAGGTC-1	Cardiomyocytes
CGAAGAATCTTGGATA-1	Cardiomyocytes
CGAAGCCTCCTCAGCT-1	Fibroblasts
CGAAGCCTCTTGAGCG-1	Cardiomyocytes
CGAAGCGAGGGTTAGA-1	Endothelial
CGAAGTAAGCTGGAAA-1	Fibroblasts
CGAAGTAAGGAGGACT-1	Smooth.muscle
CGAATCTAGCGAAGTA-1	Smooth.muscle
CGACAAGCAACTAGCC-1	Cardiomyocytes
CGAGCGAAGACACCGC-1	Fibroblasts
CGAGCGAAGTGTTGTA-1	Cardiomyocytes
CGAGCTGGTAATAACC-1	Cardiomyocytes
CGAGGAAGTAGCTGGT-1	Fibroblasts
CGAGGAAGTTAGACCA-1	Fibroblasts
CGAGGAAGTTTAACCC-1	Pericytes
CGAGGCAAGGACAATG-1	Fibroblasts
CGAGTCGGTGACCTGG-1	Cardiomyocytes
CGATATTCACTTAGGC-1	Endothelial
CGATCCTTCCGCCTAT-1	Cardiomyocytes
CGATGTCCACCTGCTC-1	Endothelial
CGATTATCAAGGTCCT-1	Endothelial
CGATTATCAGTCTAAT-1	Cardiomyocytes
CGATTATCATACTCCT-1	Fibroblasts
CGATTATCATGGCCTG-1	Fibroblasts
CGCAAATTCGCTAGTG-1	Pericytes
CGCAATAGTCAAAGAA-1	Fibroblasts
CGCAATAGTTTCCTCC-1	Fibroblasts
CGCAATCCAACACTTG-1	Cardiomyocytes
CGCAATCCACTAAGTT-1	Fibroblasts
CGCAATGTCTTGTCTG-1	Cardiomyocytes
CGCACAATCATGCTTT-1	Neuronal
CGCACAATCTAGCTTT-1	Fibroblasts
CGCACACAGAACCTGT-1	Cardiomyocytes
CGCACACAGTGTTGTA-1	Cardiomyocytes
CGCACCACAACCGCCA-1	Cardiomyocytes
CGCACCACACAGCCAT-1	Cardiomyocytes
CGCACCACACGAATCC-1	Smooth.muscle
CGCATATAGAGGAGGA-1	Cardiomyocytes
CGCATGATCACAGCGC-1	Endothelial
CGCATGATCGGCTATG-1	Endothelial
CGCATTACAAGCTAAA-1	Endothelial
CGCATTACAATCCTAG-1	Endothelial
CGCATTACACGGTACT-1	Endothelial
CGCATTTGTCCTAGTT-1	Cardiomyocytes
CGCATTTGTTAGCCAA-1	Cardiomyocytes
CGCCAAATCACTTCAT-1	Fibroblasts
CGCCAAATCATAGACC-1	Smooth.muscle
CGCCACACACTTAACG-1	Endothelial
CGCCACACAGCTACGT-1	Cardiomyocytes
CGCCTCATCGTACCGA-1	Cardiomyocytes
CGCGATTCACAAAGAC-1	Cardiomyocytes
CGCGGATTCAAGCTTA-1	Fibroblasts
CGCGGATTCATTAGGC-1	Pericytes
CGCGGATTCCAGCACA-1	Cardiomyocytes
CGCTAACCAGTTATCG-1	Cardiomyocytes
CGCTACTTCCAAGTTA-1	Cardiomyocytes
CGCTACTTCTACTAAG-1	Cardiomyocytes
CGCTATGAGCGGGCAA-1	Endothelial
CGCTATGAGGATAAAC-1	Cardiomyocytes
CGCTATGAGTTGGATC-1	Cardiomyocytes
CGCTCCATCATGTTTC-1	Smooth.muscle
CGCTCCATCCAAACAC-1	Cardiomyocytes
CGCTCCATCGGGACTC-1	Cardiomyocytes
CGCTGTGCAAGGGTTG-1	Cardiomyocytes
CGCTGTGCAGGTTAAA-1	Pericytes
CGCTGTGCAGTTGCGT-1	Myeloid
CGCTTAACATAGCAGG-1	Fibroblasts
CGCTTACTCCTTAAGA-1	Fibroblasts
CGCTTACTCGCACAAT-1	Endothelial
CGCTTCTAGCAAGGTA-1	Cardiomyocytes
CGGAATCGTTACCGGG-1	Endothelial
CGGACAACAGTCTAGC-1	Fibroblasts
CGGACAACATCCCTCA-1	Endothelial
CGGACAACATTGCGGT-1	Pericytes
CGGAGCAAGCTGGACC-1	Pericytes
CGGAGTCTCCTTCGTA-1	Cardiomyocytes
CGGATAAAGGCTGTGC-1	Cardiomyocytes
CGGATTAGTACAATGT-1	Cardiomyocytes
CGGATTAGTCAAACTG-1	Fibroblasts
CGGATTAGTCAAGTGC-1	Smooth.muscle
CGGATTAGTGTCACGG-1	Fibroblasts
CGGATTAGTTACAACG-1	Endothelial
CGGATTAGTTAGAGCC-1	Cardiomyocytes
CGGCAATGTAGCTGGT-1	Endothelial
CGGCCATAGTGAGAGC-1	Myeloid
CGGCCATAGTGAGGTA-1	Fibroblasts
CGGCTAATCATGCTAA-1	Cardiomyocytes
CGGCTAATCCTCCTAA-1	Pericytes
CGGCTAATCTCAATTC-1	Endothelial
CGGCTCACACGTGCTG-1	Fibroblasts
CGGGACAAGCGATACT-1	Pericytes
CGGGCTTAGCCGCTTT-1	Fibroblasts
CGGGCTTAGCCTGACA-1	Endothelial
CGGGCTTAGTAACTCA-1	Fibroblasts
CGGGTCTAGAGAGGCT-1	Cardiomyocytes
CGGGTCTAGCATGAAG-1	Fibroblasts
CGGGTCTAGGAGCAAC-1	Fibroblasts
CGGGTCTAGTAAACCC-1	Fibroblasts
CGGTGAACACTCGCTC-1	Endothelial
CGGTGAGAGAATGACG-1	Cardiomyocytes
CGGTTATAGATTCCTT-1	Cardiomyocytes
CGGTTATAGCTCCTAC-1	Cardiomyocytes
CGGTTCCGTACCTTAC-1	Fibroblasts
CGGTTCCGTACGGTAC-1	Fibroblasts
CGGTTCCGTGATTACG-1	Cardiomyocytes
CGGTTCCGTTAAGGTT-1	Adipocytes
CGGTTGGGTAATGGCC-1	Endothelial
CGGTTGGGTATGTGGC-1	Cardiomyocytes
CGGTTGGGTGTTGTGA-1	Cardiomyocytes
CGGTTGGGTTTCCGGC-1	Fibroblasts
CGGTTTCTCTAAGTGC-1	Endothelial
CGGTTTGAGAAAGCAT-1	Cardiomyocytes
CGGTTTGAGGAACGGT-1	Cardiomyocytes
CGTAACTAGAGAGGCT-1	Fibroblasts
CGTAACTAGGGCTTTG-1	Fibroblasts
CGTACGGGTTATTGCC-1	Cardiomyocytes
CGTAGCGGTTGAGGTC-1	Myeloid
CGTAGTTAGCATGGTT-1	Endothelial
CGTAGTTAGGACCTCA-1	Cardiomyocytes
CGTAGTTAGGAGCACG-1	Fibroblasts
CGTAGTTAGGTCATTA-1	Endothelial
CGTATTGCAATTAACC-1	Endothelial
CGTATTGCAGGACCTT-1	Endothelial
CGTATTGCAGTAATAG-1	Cardiomyocytes
CGTCAATAGGTGCTGC-1	Endothelial
CGTCATTGTTTAGTCC-1	Fibroblasts
CGTCCTAGTAACCACA-1	Pericytes
CGTCCTAGTCCCGAAG-1	Cardiomyocytes
CGTCCTAGTTAGAGCC-1	Cardiomyocytes
CGTCCTAGTTTGAGCA-1	Endothelial
CGTCCTAGTTTGGGCG-1	Cardiomyocytes
CGTGCACAGCAGCTAT-1	Cardiomyocytes
CGTGCACAGCCAGGTC-1	Cardiomyocytes
CGTGCACAGGTTACAC-1	Fibroblasts
CGTGCTGCAACTCGCG-1	Fibroblasts
CGTGCTGCATGAATCT-1	Pericytes
CGTGCTGCATTGCGGT-1	Myeloid
CGTGTGTCACAATTAC-1	Cardiomyocytes
CGTGTGTCATCGTTCT-1	Cardiomyocytes
CGTGTTACACCAACCG-1	Fibroblasts
CGTGTTACATAGCTGC-1	Cardiomyocytes
CGTTAAATCAGGATGA-1	Cardiomyocytes
CGTTAAATCTTTGACT-1	Cardiomyocytes
CGTTAACAGGATGATG-1	Fibroblasts
CGTTAGGTCAAGCGCC-1	Fibroblasts
CGTTAGGTCAGGCCTA-1	Cardiomyocytes
CGTTAGGTCATCCTAT-1	Cardiomyocytes
CGTTAGTAGCCTAATA-1	Cardiomyocytes
CGTTAGTAGCTCAAAC-1	Pericytes
CGTTAGTAGCTTTGTT-1	Fibroblasts
CGTTAGTAGTAACAGG-1	Smooth.muscle
CGTTATCGTCAATACG-1	Cardiomyocytes
CGTTATCGTCATAGAT-1	Cardiomyocytes
CGTTATTTCCTAACGG-1	Fibroblasts
CGTTATTTCTCACTAT-1	Cardiomyocytes
CGTTATTTCTTAGTCT-1	Neuronal
CGTTGCGCAACCTAAT-1	Endothelial
CGTTTCTCAAAGGCCA-1	Cardiomyocytes
CGTTTCTCACTTAACG-1	Fibroblasts
CGTTTCTCAGTTGCGT-1	Neuronal
CGTTTGGAGAAAGCAT-1	Cardiomyocytes
CGTTTGGAGTAAGTGG-1	Endothelial
CTAACCTGTTTAACGG-1	Endothelial
CTAACCTGTTTATTCG-1	Fibroblasts
CTAAGGTTCGAGGAGT-1	Fibroblasts
CTAAGGTTCTAGCGAT-1	Cardiomyocytes
CTAAGTCAGGCAGGTG-1	Cardiomyocytes
CTAAGTCAGTCGCTAG-1	Cardiomyocytes
CTAATAGTCGATTATG-1	Cardiomyocytes
CTAATAGTCTGTTCAT-1	Myeloid
CTAATCGCACACAATT-1	Cardiomyocytes
CTAATCGCACCTATAG-1	Cardiomyocytes
CTAATCGCATGTCAAT-1	Cardiomyocytes
CTAATCTTCCAGGGAG-1	Pericytes
CTAATCTTCTGGTCCT-1	Endothelial
CTACCGGCACAGAAAC-1	Cardiomyocytes
CTACCGGCAGTCTAGC-1	Cardiomyocytes
CTACCTCAGTTAGAGG-1	Cardiomyocytes
CTACTAAAGCACAGCC-1	Fibroblasts
CTACTAAAGGACCTCA-1	Cardiomyocytes
CTACTAAAGGCAACAA-1	Cardiomyocytes
CTACTTAGTCATTACC-1	Endothelial
CTAGATTCAGAAACGT-1	Adipocytes
CTAGATTCAGAAATTG-1	Endothelial
CTAGATTCATGGAGGC-1	Cardiomyocytes
CTAGCGGGTCATAAGT-1	Fibroblasts
CTAGCGGGTCATCAAG-1	Pericytes
CTAGCGGGTGCTTTAC-1	Pericytes
CTAGCTGAGCCGCAAC-1	Cardiomyocytes
CTAGCTGAGGCAAGTA-1	Fibroblasts
CTAGCTTGTGCTCCGT-1	Fibroblasts
CTAGGCGGTAATTAGC-1	Myeloid
CTAGTCGAGGTAGCTT-1	Cardiomyocytes
CTAGTCGAGGTCCAAT-1	Cardiomyocytes
CTAGTGAGTCACTCGC-1	Pericytes
CTATAACCAATTTGGT-1	Fibroblasts
CTATAACCATGACTAT-1	Fibroblasts
CTATGAGGTCTAACCT-1	Cardiomyocytes
CTATGATCAAGGTCCT-1	Endothelial
CTATGATCACAAAGAC-1	Fibroblasts
CTATGGCCACAATGTT-1	Fibroblasts
CTATGGCCACCGGTAT-1	Cardiomyocytes
CTATGGCCACCTCGCT-1	Cardiomyocytes
CTATGTTTCATGACCG-1	Endothelial
CTATTACTCCCTGGTT-1	Cardiomyocytes
CTATTACTCTCCATGC-1	Endothelial
CTATTCAGTCACAGCG-1	Endothelial
CTATTGAAGCCTGATG-1	Fibroblasts
CTATTGAAGGCGCACT-1	Pericytes
CTATTGAAGGGTCCAC-1	Cardiomyocytes
CTCAATAAGCAAGATG-1	Fibroblasts
CTCAATAAGGCTAGAA-1	Myeloid
CTCACACTCAACAAGG-1	Cardiomyocytes
CTCACACTCTTGATGA-1	Fibroblasts
CTCAGGATCCCTGTTA-1	Cardiomyocytes
CTCAGGATCTCACTCA-1	Fibroblasts
CTCATCATCCTAGTAA-1	Endothelial
CTCATCATCGATCAGT-1	Fibroblasts
CTCATCATCGTTAAGC-1	Endothelial
CTCATGACACGTTACA-1	Pericytes
CTCATGCTCATCACTT-1	Fibroblasts
CTCATGCTCATGCTTT-1	Endothelial
CTCATGCTCCTAATAG-1	Endothelial
CTCATTAGTTCATTTG-1	Cardiomyocytes
CTCATTAGTTGAAGCC-1	Cardiomyocytes
CTCATTGTCACAGCCA-1	Pericytes
CTCATTGTCCATCAGG-1	Cardiomyocytes
CTCATTGTCTCTAGCC-1	Fibroblasts
CTCATTTAGGCGAAAC-1	Fibroblasts
CTCATTTAGTCTCACC-1	Fibroblasts
CTCCAAACAGCCTAAC-1	Endothelial
CTCCAAACATTAGGCC-1	Cardiomyocytes
CTCCAACTCATGCTAA-1	Fibroblasts
CTCCATCAGCGCATTG-1	Endothelial
CTCCATCAGTGAACCT-1	Pericytes
CTCCCTGAGTCACCAG-1	Endothelial
CTCCGGACATAGCTTG-1	Endothelial
CTCCGTCCAAGCTTTG-1	Endothelial
CTCCGTCCACATACTG-1	Endothelial
CTCCTAATCTCCTCTT-1	Endothelial
CTCCTGAGTTTCGCGC-1	Fibroblasts
CTCGACAAGTGGCGGA-1	Fibroblasts
CTCGCTCCACAGCCTG-1	Cardiomyocytes
CTCGTTATCATTTGTC-1	Endothelial
CTCGTTATCTTCAATC-1	Cardiomyocytes
CTCTAAGCATGATTGT-1	Cardiomyocytes
CTCTATGTCACAGACT-1	Cardiomyocytes
CTCTATGTCACCATTT-1	Cardiomyocytes
CTCTATGTCCCGAAGC-1	Cardiomyocytes
CTCTATGTCTTGATGA-1	Endothelial
CTCTGTTCAATGCGCT-1	Fibroblasts
CTCTGTTCAGGCCTTG-1	Cardiomyocytes
CTCTTGATCAAGCTAC-1	Fibroblasts
CTCTTGATCCTTAGGG-1	Fibroblasts
CTCTTGATCCTTTACG-1	Endothelial
CTCTTGATCGGGATTT-1	Cardiomyocytes
CTCTTGATCTTAGGGT-1	Cardiomyocytes
CTCTTGATCTTCAATC-1	Cardiomyocytes
CTGAAACTCAATGAGG-1	Cardiomyocytes
CTGAAACTCATTACGA-1	Smooth.muscle
CTGAATATCATGGCCA-1	Cardiomyocytes
CTGAATATCCGTCCAT-1	Smooth.muscle
CTGACATAGTCACTAA-1	Endothelial
CTGACCAAGCTCCTAC-1	Cardiomyocytes
CTGACCAAGTAAGTGG-1	Cardiomyocytes
CTGATCACAATTTAGC-1	Cardiomyocytes
CTGCAATAGACTAAGG-1	Pericytes
CTGCTACTCACAGCCA-1	Endothelial
CTGCTACTCACCTGTC-1	Smooth.muscle
CTGCTACTCCTCACAC-1	Cardiomyocytes
CTGCTACTCTCACTAT-1	Cardiomyocytes
CTGCTATGTATTGTGG-1	Cardiomyocytes
CTGCTCCCAATATAGG-1	Fibroblasts
CTGGACCAGGTAACGA-1	Fibroblasts
CTGGACCAGGTCCGTA-1	Cardiomyocytes
CTGGACCAGTCACCTC-1	Cardiomyocytes
CTGGATGTCGAGCAAA-1	Pericytes
CTGGCTAAGGCTAGAA-1	Fibroblasts
CTGGCTAAGTAAGTCC-1	Fibroblasts
CTGGTAAGTCATGAGC-1	Fibroblasts
CTGGTAAGTCGCAATA-1	Endothelial
CTGGTCAAGAGAAGGG-1	Smooth.muscle
CTGGTCAAGCTGGCTA-1	Cardiomyocytes
CTGGTCAAGGCGCACT-1	Pericytes
CTGGTTACAAGGTATA-1	Endothelial
CTGGTTACACTGGCTG-1	Endothelial
CTGGTTTGTCATGCCC-1	Cardiomyocytes
CTGTAACAGTTGTCAA-1	Cardiomyocytes
CTGTACCTCCTAAGTA-1	Fibroblasts
CTGTATTTCACCAATA-1	Fibroblasts
CTGTATTTCATCCTCA-1	Fibroblasts
CTGTATTTCTAACCAA-1	Pericytes
CTGTGTGAGGAACGGT-1	Cardiomyocytes
CTGTTAAAGCCTCTGT-1	Pericytes
CTGTTAAAGGATTGAG-1	Cardiomyocytes
CTGTTAAAGGGATTAG-1	Fibroblasts
CTGTTAAAGTCCTTTG-1	Endothelial
CTGTTAAAGTTTGGGT-1	Fibroblasts
CTGTTCATCAAGCGCC-1	Cardiomyocytes
CTGTTGGAGCGCAATT-1	Fibroblasts
CTGTTGGAGTAAGGGC-1	Fibroblasts
CTGTTGGAGTCAGGCC-1	Endothelial
CTGTTTAGTCCCGGAA-1	Adipocytes
CTTAACAAGAGGGACT-1	Endothelial
CTTAACAAGCGCTAAT-1	Pericytes
CTTAACAAGTTTCCTG-1	Endothelial
CTTAAGATCATGCTAA-1	Neuronal
CTTAAGATCCTCACAC-1	Cardiomyocytes
CTTAAGATCGCCTAAG-1	Fibroblasts
CTTAAGATCGTTACAA-1	Endothelial
CTTAAGGGTTCACCCA-1	Endothelial
CTTAATGAGAGAGGAG-1	Cardiomyocytes
CTTAATGAGCCTGACA-1	Fibroblasts
CTTACCGGTGCTCCGT-1	Endothelial
CTTACCGGTGGTTAGC-1	Endothelial
CTTACCTCACCACAAC-1	Cardiomyocytes
CTTACCTCACCCACCT-1	Cardiomyocytes
CTTACCTCAGTAGGTG-1	Cardiomyocytes
CTTACCTCATCTAGCA-1	Smooth.muscle
CTTACTAGTTAAGCCA-1	Fibroblasts
CTTACTAGTTCACCAT-1	Cardiomyocytes
CTTAGGAGTTTATCTG-1	Fibroblasts
CTTAGTTTCCCTTGCG-1	Endothelial
CTTATGTTCAGTGAAG-1	Cardiomyocytes
CTTATGTTCCACCTTA-1	Endothelial
CTTATGTTCCCTCATA-1	Cardiomyocytes
CTTATGTTCTCCATGC-1	Fibroblasts
CTTATTGGTGCATTAG-1	Endothelial
CTTCAAGCACACTAAT-1	Cardiomyocytes
CTTCAATTCGCTAGAT-1	Cardiomyocytes
CTTCAATTCTACCTCA-1	Cardiomyocytes
CTTCACTCAGGGAGGA-1	Cardiomyocytes
CTTCATCCAAAGCTCC-1	Endothelial
CTTCATCCAATCGCAC-1	Cardiomyocytes
CTTCATCCACATAACT-1	Cardiomyocytes
CTTCATCCATTGTGTG-1	Fibroblasts
CTTCGCGTCATTAGTG-1	Fibroblasts
CTTCGCGTCCTCATCA-1	Neuronal
CTTCGCGTCCTTTACG-1	Cardiomyocytes
CTTCTAAGTCTATCGT-1	Fibroblasts
CTTCTCAAGCTAGAAG-1	Cardiomyocytes
CTTCTCAAGCTATTAG-1	Cardiomyocytes
CTTCTCAAGGTGAAAT-1	Pericytes
CTTGAACAGGGCTAAA-1	Endothelial
CTTGAACAGTCTCACC-1	Endothelial
CTTGAATCACTGGCTG-1	Cardiomyocytes
CTTGACGAGCGGATTT-1	Fibroblasts
CTTGCAACACTGACCG-1	Fibroblasts
CTTGCAACAGCCTTGG-1	Myeloid
CTTGCATGTCCAAATG-1	Fibroblasts
CTTGCATGTTCCGCAC-1	Smooth.muscle
CTTGCATGTTTAGTCC-1	Cardiomyocytes
CTTGCGCGTCGTAAAT-1	Cardiomyocytes
CTTGCGCGTTAGGTGC-1	Cardiomyocytes
CTTGTAAAGGAACGCG-1	Fibroblasts
CTTGTCCAGACTTACA-1	Endothelial
CTTGTCCAGCGATACT-1	Endothelial
CTTGTCCAGCTAATTG-1	Endothelial
CTTGTCCAGCTATTAG-1	Cardiomyocytes
CTTGTCCAGGCAGGTG-1	Fibroblasts
CTTGTTCCACATAGCC-1	Cardiomyocytes
CTTGTTCCAGTTAAAG-1	Cardiomyocytes
CTTGTTCCATTGTTGG-1	Cardiomyocytes
CTTGTTTAGGCTAGAA-1	Fibroblasts
CTTGTTTAGTAAGTGG-1	Myeloid
CTTTAGGCATAATCGT-1	Cardiomyocytes
CTTTAGTTCTCATCAT-1	Cardiomyocytes
CTTTCTTGTCACAAAT-1	Endothelial
CTTTGAGCACCTCACC-1	Cardiomyocytes
CTTTGAGCATACCCGG-1	Fibroblasts
CTTTGGGAGGTAACGA-1	Cardiomyocytes
CTTTGGGAGGTGAAAT-1	Endothelial
CTTTGGGAGTACCGCA-1	Cardiomyocytes
CTTTGGTGTAATCGGC-1	Fibroblasts
CTTTGGTGTAGTTACG-1	Cardiomyocytes
CTTTGGTGTCAACAAT-1	Cardiomyocytes
CTTTGGTGTTATGTGG-1	Fibroblasts
CTTTGTCCAGTAAGTA-1	Endothelial
GAAACCCGTCAAGTGC-1	Cardiomyocytes
GAAACCCGTGACATGC-1	Endothelial
GAAACCCGTGTTAAAC-1	Pericytes
GAAAGCCAGTTGGGCC-1	Fibroblasts
GAACACAAGAGCAAGC-1	Cardiomyocytes
GAACACAAGCACGTTG-1	Cardiomyocytes
GAACCAAAGACAAAGT-1	Cardiomyocytes
GAACCAAAGATAGACG-1	Adipocytes
GAACCAAAGCACGTTG-1	Endothelial
GAACCAAAGCTTAGTA-1	Endothelial
GAACCAAAGTAAGGGC-1	Cardiomyocytes
GAACCAGCAATCCTAG-1	Endothelial
GAACCAGCACTAAGAA-1	Cardiomyocytes
GAACCAGCATTATGCG-1	Fibroblasts
GAACCTGTCGGTTTGG-1	Fibroblasts
GAACCTTAGAATCGCT-1	Fibroblasts
GAACGAATCGTAACGT-1	Fibroblasts
GAACTTATCCTAAATG-1	Cardiomyocytes
GAACTTATCTAGCGTG-1	Endothelial
GAAGCTAAGGTCAAAG-1	Fibroblasts
GAAGGAACAAGTGTCC-1	Cardiomyocytes
GAAGGAACAATTATGC-1	Cardiomyocytes
GAAGGAACATTATGCG-1	Endothelial
GAAGGATGTAACGTGC-1	Smooth.muscle
GAAGGATGTACCGGAT-1	Cardiomyocytes
GAAGTAAGTCACAGCG-1	Smooth.muscle
GAAGTATAGTGAACAG-1	Endothelial
GAAGTCAAGCCTAATA-1	Endothelial
GAAGTGATCTAACTGA-1	Endothelial
GAATTTGTCAAACCGT-1	Cardiomyocytes
GAATTTGTCATGCAAC-1	Pericytes
GACAATACACATAGCC-1	Cardiomyocytes
GACAATACATAATCAC-1	Fibroblasts
GACACCGGTGAGCGAA-1	Cardiomyocytes
GACACCGGTTTAGCTC-1	Cardiomyocytes
GACATAGAGACAGGTA-1	Pericytes
GACATAGAGGCGAATA-1	Cardiomyocytes
GACATAGAGTACCGCA-1	Cardiomyocytes
GACCGAACAGTTTCTC-1	Cardiomyocytes
GACCGTTCAATATGGA-1	Fibroblasts
GACCGTTCACAACAGG-1	Cardiomyocytes
GACCTAGTCACCATTT-1	Endothelial
GACCTAGTCATTTGTC-1	Cardiomyocytes
GACCTAGTCCGCAAGC-1	Cardiomyocytes
GACCTAGTCTACCTAT-1	Cardiomyocytes
GACCTAGTCTTGGATA-1	Cardiomyocytes
GACCTCAAGCGCCTAA-1	Cardiomyocytes
GACCTGATCGCTATGG-1	Cardiomyocytes
GACCTGATCTCAATTC-1	Cardiomyocytes
GACCTGCAGCCGCAGT-1	Cardiomyocytes
GACCTGCAGGAACACA-1	Fibroblasts
GACCTGCAGTTCCTGC-1	Cardiomyocytes
GACCTTTGTGCATTAG-1	Endothelial
GACGCAACATCAGCAC-1	Fibroblasts
GACGCCTAGCTAAAGG-1	Cardiomyocytes
GACGCCTAGGCCGGAA-1	Cardiomyocytes
GACGTAAAGCAGCTCA-1	Fibroblasts
GACGTAAAGGTTTGCG-1	Endothelial
GACTAATGTCATTAGG-1	Fibroblasts
GACTAATGTGATTTGG-1	Smooth.muscle
GACTAATGTTTCAGGA-1	Endothelial
GACTCACCATAAGCAA-1	Fibroblasts
GACTCACCATGAATAG-1	Endothelial
GACTTACAGGGATGAC-1	Cardiomyocytes
GACTTACAGTAACCCG-1	Endothelial
GACTTAGGTGAACAAA-1	Endothelial
GACTTAGGTTAGAGCC-1	Endothelial
GACTTAGGTTTATTCG-1	Fibroblasts
GACTTGGTCAATCATG-1	Cardiomyocytes
GAGAACCAGCCAGGTC-1	Cardiomyocytes
GAGAACCAGGGACTAA-1	Endothelial
GAGAGGCGTCCCGGAA-1	Myeloid
GAGAGGCGTGAGCAAG-1	Fibroblasts
GAGAGGCGTTAAGCTG-1	Cardiomyocytes
GAGATAAGTCGCAATA-1	Neuronal
GAGCAAATCAAGACTC-1	Neuronal
GAGCAAGGTTGAATCG-1	Pericytes
GAGCATGCATAGCGAG-1	Pericytes
GAGCCACTCAAACCGT-1	Fibroblasts
GAGCCACTCATAAGCC-1	Cardiomyocytes
GAGCCTTCAGGTTAAA-1	Fibroblasts
GAGCGAAGTTCATCTA-1	Cardiomyocytes
GAGCGATAGGCTAGAA-1	Cardiomyocytes
GAGCGGTCAAGGTCGA-1	Cardiomyocytes
GAGCTAGCAAGGTACG-1	Cardiomyocytes
GAGCTAGCATTGTCCT-1	Cardiomyocytes
GAGCTGCTCATGAGCT-1	Cardiomyocytes
GAGCTTAGTGTTGCTT-1	Fibroblasts
GAGGACTAGCTGGAAA-1	Cardiomyocytes
GAGGAGGCACAATACT-1	Pericytes
GAGGAGGCAGCAACCT-1	Endothelial
GAGGCAAGTAATCCCT-1	Cardiomyocytes
GAGGCAAGTACTTAGG-1	Fibroblasts
GAGGCAAGTAGGATCC-1	Cardiomyocytes
GAGGCAAGTATTACCC-1	Cardiomyocytes
GAGGCAAGTTATCCGT-1	Endothelial
GAGGCCTTCGTTCACC-1	Smooth.muscle
GAGGCTACACAAAGCG-1	Cardiomyocytes
GAGGCTACAGGATGGC-1	Cardiomyocytes
GAGGTACAGCGAAGTA-1	Cardiomyocytes
GAGGTAGGTTGCGTAA-1	Cardiomyocytes
GAGGTGAGTGTGCACG-1	Endothelial
GAGGTGAGTTAACGAT-1	Fibroblasts
GAGGTGAGTTTGGGTA-1	Cardiomyocytes
GAGTAACCAAATTGCT-1	Cardiomyocytes
GAGTAATAGCTATGAC-1	Cardiomyocytes
GAGTATCTCCAAGTGT-1	Endothelial
GAGTCAAAGAGGAGTC-1	Cardiomyocytes
GAGTCAAAGTACTGGT-1	Cardiomyocytes
GAGTCATTCACGCCAA-1	Cardiomyocytes
GAGTGAGGTAACCTAG-1	Cardiomyocytes
GAGTGAGGTACCGTAA-1	Endothelial
GAGTGAGGTTTGTGGA-1	Endothelial
GAGTGTTTCAGCTAAC-1	Fibroblasts
GAGTGTTTCGCTAAGT-1	Fibroblasts
GAGTGTTTCTACCTCA-1	Cardiomyocytes
GAGTTACTCAGGAACA-1	Adipocytes
GAGTTACTCCGCCTCA-1	Cardiomyocytes
GAGTTACTCTGGCTTC-1	Smooth.muscle
GAGTTACTCTTTGACT-1	Cardiomyocytes
GAGTTGCGTCTCACTG-1	Endothelial
GAGTTGCGTTCGGTAA-1	Endothelial
GAGTTGCGTTGTAAAC-1	Fibroblasts
GAGTTGCGTTGTCCAT-1	Smooth.muscle
GAGTTTGGTAATGGAA-1	Cardiomyocytes
GATAACGAGACAGGCG-1	Cardiomyocytes
GATAACGAGGCCATCA-1	Cardiomyocytes
GATAACGAGGCGGATG-1	Neuronal
GATAAGCCATTAAACC-1	Fibroblasts
GATAGACCAAGGTATA-1	Cardiomyocytes
GATAGACCATTGTGTG-1	Fibroblasts
GATCAAGAGGATGATG-1	Cardiomyocytes
GATCAAGAGTCAGTAC-1	Cardiomyocytes
GATCAAGAGTGCACGC-1	Fibroblasts
GATCACTAGTTGTCTT-1	Endothelial
GATCAGGCATGGCCCA-1	Cardiomyocytes
GATCAGTTCATGGCTG-1	Endothelial
GATCAGTTCCGCCTAT-1	Endothelial
GATCCGTCACATTGCA-1	Endothelial
GATCCGTCATTGCGTA-1	Pericytes
GATCGAGCACTGACCG-1	Endothelial
GATCGAGCAGGAATCG-1	Pericytes
GATCGAGCAGGCTAGA-1	Pericytes
GATCGATTCGCCTAAG-1	Fibroblasts
GATCGCTCAAAGCTAA-1	Cardiomyocytes
GATCGCTCACACAATT-1	Cardiomyocytes
GATGACTTCGGTAACT-1	Fibroblasts
GATGAGGGTAGTAAGA-1	Endothelial
GATGAGGGTGGTTATG-1	Cardiomyocytes
GATGCAGCAGGCGATA-1	Fibroblasts
GATGCATTCGAGGTGG-1	Cardiomyocytes
GATGCGACACAAGCCT-1	Endothelial
GATGCTTAGCATTAGC-1	Cardiomyocytes
GATGCTTAGGTTACGT-1	Fibroblasts
GATGGACAGGCCATCA-1	Pericytes
GATGGACAGTCAGGCC-1	Endothelial
GATGGACAGTCTCACC-1	Endothelial
GATGGCTGTACGGGTT-1	Cardiomyocytes
GATTAAGCACTATGGC-1	Cardiomyocytes
GATTAAGCAGATAGAC-1	Cardiomyocytes
GATTAAGCAGGTATTT-1	Fibroblasts
GATTAAGCATGTTGGC-1	Endothelial
GATTACGGTGCTGGTG-1	Fibroblasts
GATTACGGTTGCTTCG-1	Cardiomyocytes
GATTACGGTTTCCTCC-1	Fibroblasts
GATTACTCAAGGACCA-1	Pericytes
GATTACTCATTATGCG-1	Cardiomyocytes
GATTAGCTCCCTCAAC-1	Pericytes
GATTAGCTCGATTTGA-1	Fibroblasts
GATTAGCTCTTAGCCC-1	Cardiomyocytes
GATTAGTGTTTGAGGC-1	Cardiomyocytes
GATTAGTGTTTGCAGA-1	Endothelial
GATTATGTCGGTTCCT-1	Cardiomyocytes
GATTCAATCAATGAGG-1	Fibroblasts
GATTCAGGTAGGTGTC-1	Endothelial
GATTCATCAAGCGATG-1	Cardiomyocytes
GATTCATCACGAATCC-1	Fibroblasts
GATTCATCATAGTCAT-1	Myeloid
GATTCATCATGTTTGG-1	Pericytes
GATTCCTGTTACTTCA-1	Fibroblasts
GATTCCTGTTATCCTA-1	Cardiomyocytes
GATTCGCCATAAGTTC-1	Smooth.muscle
GATTGATGTAGTTAAC-1	Endothelial
GATTGATGTCCCGAAG-1	Fibroblasts
GATTGGCGTAGCTAGC-1	Cardiomyocytes
GATTGGTTCATAGCCG-1	Cardiomyocytes
GATTGGTTCTGCAAAC-1	Fibroblasts
GATTGTTCATAGCAGG-1	Endothelial
GATTTGCAGTATTGGC-1	Neuronal
GCAAACAAGCGCTCAA-1	Cardiomyocytes
GCAAACAAGGCATTAC-1	Cardiomyocytes
GCAAACAAGTAATCCA-1	Fibroblasts
GCAAACCGTAGCCTCC-1	Endothelial
GCAAACCGTTCCTGAT-1	Cardiomyocytes
GCAAACTTCTTGACCC-1	Endothelial
GCAAGTCGTAATAACC-1	Fibroblasts
GCAAGTCGTCCAAATG-1	Adipocytes
GCAAGTCGTGTTGTGA-1	Cardiomyocytes
GCAAGTCGTTCCTCCT-1	Endothelial
GCAAGTCGTTTCGCGC-1	Cardiomyocytes
GCAAGTGCAAGCTTAT-1	Smooth.muscle
GCAAGTGCACAAAGCG-1	Cardiomyocytes
GCAAGTGCAGCAAGGC-1	Endothelial
GCAAGTGCAGTAGGAT-1	Endothelial
GCAATAGAGAAAGCAT-1	Cardiomyocytes
GCAATAGAGGAACGCG-1	Fibroblasts
GCAATAGAGGAATAAC-1	Cardiomyocytes
GCAATAGAGTAGCTTA-1	Cardiomyocytes
GCAATAGAGTGTTGTA-1	Cardiomyocytes
GCAATAGAGTTAGACC-1	Fibroblasts
GCAATCTAGCAACAAG-1	Cardiomyocytes
GCAATCTAGCCTGAGC-1	Cardiomyocytes
GCAATCTAGTAGCCAT-1	Cardiomyocytes
GCAATGAAGCTATTAG-1	Cardiomyocytes
GCACATTAGCAACAAG-1	Endothelial
GCACATTAGCCAGGTC-1	Cardiomyocytes
GCACCTAAGGGCCATC-1	Fibroblasts
GCACCTAAGGTCCTAG-1	Neuronal
GCACGAACAACTAGGG-1	Cardiomyocytes
GCACGAACACAAACTT-1	Cardiomyocytes
GCACGAACAGGCTACT-1	Cardiomyocytes
GCACGCTAGAGAGGAG-1	Cardiomyocytes
GCACGCTAGCAGGTTT-1	Cardiomyocytes
GCACTAAGTACAAAGA-1	Endothelial
GCACTAAGTTGTTGTC-1	Cardiomyocytes
GCACTTACAAGGTAAC-1	Fibroblasts
GCACTTACAGGCTAGA-1	Fibroblasts
GCAGCAACACTGGCCA-1	Fibroblasts
GCAGCAACAGGTTATT-1	Fibroblasts
GCAGCCAGTAGCAGCT-1	Endothelial
GCAGCCAGTATTGGAT-1	Endothelial
GCAGGAAGTCACGAAC-1	Fibroblasts
GCAGGATAGAGCAAGC-1	Cardiomyocytes
GCAGGATAGATTGAGG-1	Fibroblasts
GCAGGATAGCAAGATG-1	Fibroblasts
GCAGGATAGGACCTTG-1	Fibroblasts
GCAGGATAGTTAGAGG-1	Endothelial
GCAGGCAAGCCGCTTT-1	Cardiomyocytes
GCAGGCAAGGGACTAA-1	Adipocytes
GCAGGCAAGTAGCCAT-1	Pericytes
GCAGGCTTCCTGAGTG-1	Cardiomyocytes
GCAGGCTTCTCCATGC-1	Cardiomyocytes
GCAGGTGAGACAGGTA-1	Cardiomyocytes
GCAGGTGAGGCTAGAA-1	Fibroblasts
GCAGGTTGTAGCCTAA-1	Endothelial
GCAGGTTGTTTATTCG-1	Fibroblasts
GCATATATCAGGCCTA-1	Cardiomyocytes
GCATATATCGTTAGCG-1	Cardiomyocytes
GCATATATCTAGCTTT-1	Endothelial
GCATCCTTCACATTGA-1	Fibroblasts
GCATGAAAGTCAATCA-1	Fibroblasts
GCATGAGCATCCTGAA-1	Endothelial
GCATTGCCACGTAAGG-1	Endothelial
GCATTGCCAGCATTAT-1	Cardiomyocytes
GCATTGCCATAATTGC-1	Smooth.muscle
GCCAATAGTTAGCCAA-1	Myeloid
GCCAATTAGGCTGTCA-1	Pericytes
GCCAATTAGGGATGAC-1	Fibroblasts
GCCAATTAGGTGCGGA-1	Cardiomyocytes
GCCACAATCATGGTTA-1	Fibroblasts
GCCACACAGTGCTGTG-1	Cardiomyocytes
GCCACTAAGCTATTAG-1	Cardiomyocytes
GCCACTAAGGAGCACG-1	Fibroblasts
GCCACTAAGGGATGCG-1	Cardiomyocytes
GCCAGGTTCCGGGACT-1	Cardiomyocytes
GCCATGATCACGCCAA-1	Cardiomyocytes
GCCATGATCTATTGTC-1	Endothelial
GCCATTACAATATAGG-1	Cardiomyocytes
GCCATTACACTTCACT-1	Fibroblasts
GCCATTACAGCACGAA-1	Endothelial
GCCCATAAGCAGGTTT-1	Pericytes
GCCCGTTGTGCTCCGT-1	Cardiomyocytes
GCCCTCATCCTCATCA-1	Cardiomyocytes
GCCTAATAGGGACTAA-1	Cardiomyocytes
GCCTAATAGGTTTACA-1	Pericytes
GCCTAATAGTACTGGT-1	Cardiomyocytes
GCCTACTTCAAATCGC-1	Cardiomyocytes
GCCTACTTCAGCTAAC-1	Cardiomyocytes
GCCTACTTCATTAGGC-1	Endothelial
GCCTATTGTGGTTCCC-1	Endothelial
GCCTATTGTTGTAACG-1	Cardiomyocytes
GCCTCAAAGGACTTAC-1	Fibroblasts
GCCTGACAGGGTGAAC-1	Pericytes
GCCTGACAGTTTAACG-1	Neuronal
GCCTGTGCAAACGGGC-1	Cardiomyocytes
GCCTGTGCATAGACTT-1	Fibroblasts
GCCTTAACAATTTAGC-1	Cardiomyocytes
GCCTTAACATTCCTCG-1	Fibroblasts
GCCTTACTCATGCTAA-1	Endothelial
GCCTTACTCCTTCGTA-1	Fibroblasts
GCCTTGCGTAATCGTG-1	Cardiomyocytes
GCGAAGCCACTGACTA-1	Pericytes
GCGAAGCCAGCCAGTT-1	Fibroblasts
GCGAAGCCATAAGTCT-1	Cardiomyocytes
GCGAAGCCATGTTGCA-1	Endothelial
GCGAAGTAGACTATTG-1	Smooth.muscle
GCGAAGTAGCGAGTAA-1	Endothelial
GCGAAGTAGGGTTAGA-1	Fibroblasts
GCGAGTGAGTAACGAG-1	Cardiomyocytes
GCGAGTGAGTAGCTTA-1	Endothelial
GCGATATTCCTGATGG-1	Cardiomyocytes
GCGATATTCGACCTGA-1	Cardiomyocytes
GCGATTAGTAGGATCC-1	Endothelial
GCGATTAGTCAAACTG-1	Cardiomyocytes
GCGATTAGTCTTACTA-1	Cardiomyocytes
GCGATTAGTGATTTGG-1	Cardiomyocytes
GCGATTTAGTAGCTTA-1	Fibroblasts
GCGCAAACAGGTCCTG-1	Fibroblasts
GCGCAATGTAAACAAG-1	Fibroblasts
GCGCAATGTAACGTGC-1	Cardiomyocytes
GCGCAATGTATTGGAT-1	Fibroblasts
GCGCAATGTGATTACG-1	Cardiomyocytes
GCGCAATGTGTTAAAC-1	Fibroblasts
GCGCCTTGTCATGCCC-1	Cardiomyocytes
GCGCCTTGTCCTTAGT-1	Pericytes
GCGCCTTGTGTTGCAA-1	Endothelial
GCGCCTTGTTTGTCTA-1	Cardiomyocytes
GCGCGATTCAATGAGG-1	Cardiomyocytes
GCGCGATTCCAAATCA-1	Fibroblasts
GCGCGATTCCCTTGCG-1	Myeloid
GCGCTAGGTAGCCTAA-1	Neuronal
GCGCTAGGTTAGAGCC-1	Cardiomyocytes
GCGCTTGCAGGGAGGA-1	Cardiomyocytes
GCGCTTGCATCACTTC-1	Pericytes
GCGGAACCAATGCGCT-1	Fibroblasts
GCGGAACCAGGTTACC-1	Fibroblasts
GCGGATACAATAGCAA-1	Fibroblasts
GCGGATACACTTAGGC-1	Pericytes
GCGGATACATGCTTAG-1	Endothelial
GCGTGCTAGGAGGGTT-1	Cardiomyocytes
GCGTGCTAGTGAGAGC-1	Endothelial
GCGTTTCTCAGGCCTA-1	Cardiomyocytes
GCGTTTCTCCTAAGAC-1	Cardiomyocytes
GCGTTTCTCTTGGATA-1	Cardiomyocytes
GCTAACAGTCGTAATG-1	Cardiomyocytes
GCTAACAGTTAGAGCC-1	Pericytes
GCTAACCCATTGTGGC-1	Pericytes
GCTAAGAAGACACCGC-1	Fibroblasts
GCTAAGCGTTTAGCGA-1	Endothelial
GCTAAGTTCCGCACAA-1	Cardiomyocytes
GCTAAGTTCTCACTCA-1	Cardiomyocytes
GCTAATATCAATGAGG-1	Cardiomyocytes
GCTAATATCAATTGGC-1	Cardiomyocytes
GCTAATATCACCTGCT-1	Cardiomyocytes
GCTAGCCAGGAGTAAT-1	Pericytes
GCTAGCGGTATTGTCC-1	Neuronal
GCTAGCGGTTACAACG-1	Smooth.muscle
GCTAGCTCAGGGAGGA-1	Endothelial
GCTAGTGTCAAACTCA-1	Endothelial
GCTAGTGTCAAGCCTG-1	Cardiomyocytes
GCTAGTGTCCAGGAAA-1	Fibroblasts
GCTATAGGTAGCCTCC-1	Cardiomyocytes
GCTATAGGTTTACTTG-1	Fibroblasts
GCTATCCTCAATAGCC-1	Cardiomyocytes
GCTATTGCAAATACCT-1	Cardiomyocytes
GCTCAACCATTAGGTT-1	Smooth.muscle
GCTCATTGTGCGCAAT-1	Cardiomyocytes
GCTCCTTAGAAGGTGC-1	Endothelial
GCTCCTTAGGCACAGG-1	Endothelial
GCTCCTTAGTCACTAA-1	Endothelial
GCTCGATCAGGTTATT-1	Fibroblasts
GCTCGATCATGCTATG-1	Pericytes
GCTCTGGCAGTACCGT-1	Endothelial
GCTCTGGCATGAAATG-1	Cardiomyocytes
GCTCTGTTCCGCCAAA-1	Fibroblasts
GCTCTGTTCTGTAATG-1	Fibroblasts
GCTGACATCAGGATGA-1	Endothelial
GCTGACCAGTTACCGG-1	Fibroblasts
GCTGAGGAGCCAGGTC-1	Fibroblasts
GCTGATCCAATTGCGC-1	Smooth.muscle
GCTGATCCAGCTTACA-1	Fibroblasts
GCTGCAATCAAGCTTA-1	Cardiomyocytes
GCTGCAATCCCTCTAA-1	Smooth.muscle
GCTGCAATCCGGGACT-1	Fibroblasts
GCTGCAATCTTTGAGA-1	Cardiomyocytes
GCTGCACAGCAATAGG-1	Endothelial
GCTGCACAGCAGCTAT-1	Endothelial
GCTGCACAGTTAGAGG-1	Adipocytes
GCTGCACAGTTTGAGC-1	Endothelial
GCTGCATCACTGGCTG-1	Myeloid
GCTGGATGTTGGTGAC-1	Cardiomyocytes
GCTGGTTCAAGCCACT-1	Myeloid
GCTGGTTCAAGGTCGA-1	Endothelial
GCTGGTTCATGTCAGC-1	Cardiomyocytes
GCTGTAAGTACCGTTT-1	Cardiomyocytes
GCTGTAAGTTAAGCTG-1	Endothelial
GCTGTACCAGCATGAG-1	Cardiomyocytes
GCTGTGATCGGTCAAT-1	Cardiomyocytes
GCTTAAATCAATTACG-1	Cardiomyocytes
GCTTAACAGAGGAGGA-1	Fibroblasts
GCTTAACAGGGTTAGA-1	Cardiomyocytes
GCTTAACAGTCAATCA-1	Cardiomyocytes
GCTTACCTCGATAACC-1	Fibroblasts
GCTTACCTCGCAGGCT-1	Cardiomyocytes
GCTTACCTCGTCAAGT-1	Endothelial
GCTTAGTAGCCTGTTC-1	Fibroblasts
GCTTAGTAGGCTACAT-1	Endothelial
GCTTATCGTTGCACAA-1	Fibroblasts
GCTTGACCAAATATCC-1	Fibroblasts
GCTTGACCACATAGCC-1	Endothelial
GCTTGACCAGAAACGT-1	Cardiomyocytes
GCTTTACGTAGGTTTG-1	Cardiomyocytes
GCTTTACGTCAGGAAG-1	Smooth.muscle
GCTTTACGTCGCAATA-1	Cardiomyocytes
GCTTTACGTGATGAGG-1	Myeloid
GCTTTACGTGCATCGG-1	Myeloid
GCTTTATTCGGCCATA-1	Fibroblasts
GCTTTCATCATTACAG-1	Fibroblasts
GCTTTGTGTCCCGAAG-1	Cardiomyocytes
GCTTTGTGTCGCGCAA-1	Cardiomyocytes
GCTTTGTGTCTTGCAT-1	Endothelial
GGAAACTCACAAAGGT-1	Fibroblasts
GGAAACTCAGCTTAGC-1	Endothelial
GGAAACTCATAATCCG-1	Fibroblasts
GGAAACTCATAGACTT-1	Fibroblasts
GGAACCACACGGTTTA-1	Myeloid
GGAACCACAGCTTAGC-1	Endothelial
GGAACCACAGGGAGGA-1	Cardiomyocytes
GGAACCTGTGACATAT-1	Cardiomyocytes
GGAACCTGTTAGAGGG-1	Cardiomyocytes
GGAACGGTCGTTACTT-1	Cardiomyocytes
GGAACGGTCTAAGTGC-1	Neuronal
GGAACTAAGAGAGCCG-1	Pericytes
GGAACTAAGAGCCGCT-1	Adipocytes
GGAACTAAGGAACGCG-1	Cardiomyocytes
GGAAGCTAGACAAGTG-1	Cardiomyocytes
GGAAGCTAGCACCACA-1	Cardiomyocytes
GGAAGCTAGGCCTGGT-1	Cardiomyocytes
GGAATCTTCATAACTG-1	Cardiomyocytes
GGAATCTTCGCCTGTT-1	Fibroblasts
GGACAGCCATAGCAGG-1	Endothelial
GGACATAAGAAACTGG-1	Cardiomyocytes
GGACATAAGCTCATAA-1	Endothelial
GGACATAAGTACCGCA-1	Fibroblasts
GGACATAAGTGGCGGA-1	Cardiomyocytes
GGACCGAAGTGAGCGG-1	Cardiomyocytes
GGACCTCAGACAAACG-1	Myeloid
GGACCTCAGCGCATTG-1	Cardiomyocytes
GGACCTCAGGAGCACG-1	Cardiomyocytes
GGACCTCAGGAGGTTA-1	Cardiomyocytes
GGACCTCAGTTCCTGC-1	Cardiomyocytes
GGACGAAGTAGTTGGC-1	Cardiomyocytes
GGACGAAGTTCAAGAT-1	Cardiomyocytes
GGACGGATCATGCTCC-1	Pericytes
GGACGGATCGGTTCCT-1	Cardiomyocytes
GGACTAAAGCATGTTA-1	Cardiomyocytes
GGAGCATAGACTAAGG-1	Fibroblasts
GGAGCATAGTTAGTGC-1	Cardiomyocytes
GGAGCGATCATGTCAA-1	Smooth.muscle
GGAGGTTAGAATCTCA-1	Cardiomyocytes
GGAGGTTAGGATAAAC-1	Cardiomyocytes
GGAGGTTAGGCCGGAA-1	Cardiomyocytes
GGAGGTTAGGTAAGCA-1	Endothelial
GGAGTCTGTAGGTGTC-1	Endothelial
GGAGTCTGTATTGCAG-1	Fibroblasts
GGAGTCTGTCAAAGAA-1	Myeloid
GGAGTCTGTGAAACAA-1	Cardiomyocytes
GGAGTGAGTCACCAAA-1	Endothelial
GGAGTGAGTTGAAGCC-1	Cardiomyocytes
GGATATTGTGCCGCAA-1	Cardiomyocytes
GGATGAATCCTCAGTC-1	Endothelial
GGATGAATCCTTGAGG-1	Cardiomyocytes
GGATGGCCAATAATCC-1	Endothelial
GGATGTAAGTTTCCTG-1	Cardiomyocytes
GGATTATGTCTAGCTT-1	Cardiomyocytes
GGATTATGTGAAACAA-1	Cardiomyocytes
GGATTCAGTTGCGCGA-1	Fibroblasts
GGATTGCGTTGTGACA-1	Fibroblasts
GGATTTATCAGCTAAC-1	Fibroblasts
GGATTTATCTAATTGG-1	Fibroblasts
GGATTTATCTCCATAT-1	Cardiomyocytes
GGCAAATCACGTAATT-1	Pericytes
GGCAAATCAGCTTACA-1	Smooth.muscle
GGCAAGCCACCAGGTT-1	Fibroblasts
GGCAAGCCACCTCGCT-1	Fibroblasts
GGCAATCGTAGTAAGA-1	Fibroblasts
GGCAATCGTCCTAATC-1	Fibroblasts
GGCAATCGTGGTGAGA-1	Cardiomyocytes
GGCAGGATCCTCCCTC-1	Cardiomyocytes
GGCAGGATCCTGCGAA-1	Endothelial
GGCATGGAGCATTATG-1	Myeloid
GGCATGGAGGAACCAA-1	Cardiomyocytes
GGCATGGAGGACCAGG-1	Cardiomyocytes
GGCATTAGTTATCCTA-1	Cardiomyocytes
GGCATTAGTTTGGGTA-1	Cardiomyocytes
GGCATTGTCATGTGGT-1	Fibroblasts
GGCATTGTCCATAATG-1	Endothelial
GGCCAACTCAATGTGC-1	Fibroblasts
GGCCAACTCCTTAAGA-1	Cardiomyocytes
GGCCATCAGAACCTAC-1	Cardiomyocytes
GGCCATCAGCCTGATG-1	Cardiomyocytes
GGCCATCAGCGCCTTT-1	Fibroblasts
GGCCATCAGGTTAGCT-1	Cardiomyocytes
GGCCATCAGTAGGCGG-1	Smooth.muscle
GGCCATCAGTCCTTCA-1	Pericytes
GGCCGTTAGCGCTCAA-1	Myeloid
GGCCGTTAGTCATCCC-1	Fibroblasts
GGCCGTTAGTGAGCAA-1	Cardiomyocytes
GGCCGTTAGTGATTCA-1	Cardiomyocytes
GGCCTCTGTGTTTGAG-1	Endothelial
GGCCTTAAGCACTTGG-1	Endothelial
GGCCTTAAGGACCGCT-1	Smooth.muscle
GGCCTTAAGGCAGGTG-1	Endothelial
GGCCTTCGTGTTTGCT-1	Endothelial
GGCGATACAGAAACGT-1	Endothelial
GGCGATACATGTCAAT-1	Cardiomyocytes
GGCGCTAGTCATAGAT-1	Cardiomyocytes
GGCGCTAGTTTGTGGA-1	Cardiomyocytes
GGCGGTAAGTACCGCA-1	Endothelial
GGCGGTTTCCTGGCTT-1	Cardiomyocytes
GGCGGTTTCGACCTGA-1	Fibroblasts
GGCGGTTTCGCAACAT-1	Cardiomyocytes
GGCGGTTTCTCTAGCC-1	Endothelial
GGCGTTATCAGTGAAG-1	Fibroblasts
GGCGTTATCGCCTGTT-1	Fibroblasts
GGCGTTATCGTTATAG-1	Endothelial
GGCTAGACAGGCATCT-1	Pericytes
GGCTAGTGTAACCACA-1	Cardiomyocytes
GGCTATGTCAAGCCTG-1	Smooth.muscle
GGCTATGTCTGCAACG-1	Cardiomyocytes
GGCTATTAGAGGAGTC-1	Cardiomyocytes
GGCTATTAGTTATTCC-1	Fibroblasts
GGCTCAATCAAGCTAC-1	Fibroblasts
GGCTCAATCAAGCTTA-1	Pericytes
GGCTCAATCAGCACCA-1	Cardiomyocytes
GGCTCAATCATGGTGT-1	Fibroblasts
GGCTCAATCTTGCATT-1	Cardiomyocytes
GGCTGAGAGCAAGGAC-1	Endothelial
GGCTGGTTCCAGCACA-1	Cardiomyocytes
GGCTGGTTCGAGGTGG-1	Fibroblasts
GGCTGTCAGAGGGACT-1	Endothelial
GGCTGTCAGCACGTTG-1	Fibroblasts
GGCTGTCAGTAAGAAC-1	Fibroblasts
GGCTTAAGTACCCACC-1	Endothelial
GGCTTCAAGGAGGTTA-1	Cardiomyocytes
GGCTTCAAGTAGCGGG-1	Fibroblasts
GGGATTAAGCCAGGTC-1	Cardiomyocytes
GGGCAATAGGGCTTTG-1	Cardiomyocytes
GGGCATTGTTAAGTGT-1	Endothelial
GGGCGAATCATCACTT-1	Fibroblasts
GGGCGAATCCAAATCA-1	Endothelial
GGGCTAACAGAAACGT-1	Endothelial
GGGTATTTCATGCTAA-1	Cardiomyocytes
GGGTATTTCCTGCGAA-1	Fibroblasts
GGGTATTTCTACCTGC-1	Endothelial
GGGTCAACAGCATGGA-1	Cardiomyocytes
GGGTCAACATGGCCCA-1	Smooth.muscle
GGGTCACTCATAATCG-1	Smooth.muscle
GGGTCACTCCAAATCA-1	Endothelial
GGGTCACTCTGTTCAT-1	Fibroblasts
GGGTGAAGTCAAAGGG-1	Cardiomyocytes
GGGTGAAGTCATAAGT-1	Fibroblasts
GGGTTACGTTTGGGTA-1	Cardiomyocytes
GGGTTATTCAAACTCA-1	Cardiomyocytes
GGGTTATTCACTAAGC-1	Endothelial
GGGTTATTCATGCCTC-1	Cardiomyocytes
GGGTTATTCGTTACAA-1	Fibroblasts
GGGTTTCCAAAGCTCC-1	Cardiomyocytes
GGGTTTCCACCTACTT-1	Cardiomyocytes
GGTAAACCACAGCCAT-1	Cardiomyocytes
GGTAACCGTAAAGCGG-1	Cardiomyocytes
GGTAACCGTAAGCTCA-1	Pericytes
GGTAACTTCAATGAGG-1	Cardiomyocytes
GGTAACTTCGATTCTT-1	Cardiomyocytes
GGTAAGGGTCAATAGT-1	Cardiomyocytes
GGTAAGGGTGTTGCAA-1	Cardiomyocytes
GGTAATTGTGGCTTCC-1	Cardiomyocytes
GGTACAAAGCAACAAG-1	Cardiomyocytes
GGTACAAAGGAGCACG-1	Fibroblasts
GGTACAAAGTGAGAGC-1	Endothelial
GGTACAAAGTTGCGTG-1	Fibroblasts
GGTACCGGTGTTAAAC-1	Cardiomyocytes
GGTACTTAGCAAGGGT-1	Endothelial
GGTACTTAGGTCCACA-1	Cardiomyocytes
GGTACTTAGTTTGGGT-1	Cardiomyocytes
GGTAGGAGTTAGCTGA-1	Endothelial
GGTATGTTCCTCACTA-1	Cardiomyocytes
GGTATGTTCGATCAGT-1	Fibroblasts
GGTATGTTCGATTATG-1	Cardiomyocytes
GGTATTGGTACCGAAC-1	Fibroblasts
GGTATTGGTAGGATTT-1	Fibroblasts
GGTATTGGTTATAGCG-1	Fibroblasts
GGTATTTCACAGCCAT-1	Cardiomyocytes
GGTATTTCAGTCTAAT-1	Cardiomyocytes
GGTCAATTCAGTTCCC-1	Endothelial
GGTCAATTCCACCCTG-1	Pericytes
GGTCAATTCTGGTCCT-1	Fibroblasts
GGTCAGGAGGCAATAG-1	Endothelial
GGTCAGGAGTAGCGGG-1	Adipocytes
GGTCAGGAGTCTCACC-1	Fibroblasts
GGTCCATCAGTAATAG-1	Cardiomyocytes
GGTCCGTAGATTCCTT-1	Cardiomyocytes
GGTCCTGCAATAGCAA-1	Endothelial
GGTCCTGCAGTCTAAT-1	Endothelial
GGTCCTGCAGTTAGCC-1	Cardiomyocytes
GGTCCTGCATTGCGAC-1	Smooth.muscle
GGTCGGTTCCCTCTAA-1	Cardiomyocytes
GGTCGGTTCGGTCAAT-1	Fibroblasts
GGTCTTGAGGAAACTG-1	Endothelial
GGTCTTGAGGTTTGCG-1	Fibroblasts
GGTCTTTGTGAACAAA-1	Fibroblasts
GGTCTTTGTGCTAGCG-1	Cardiomyocytes
GGTCTTTGTTGCCTCA-1	Fibroblasts
GGTGAGCCAATCATGT-1	Fibroblasts
GGTGAGCCATGAGCAG-1	Fibroblasts
GGTGAGCCATTGGGAG-1	Cardiomyocytes
GGTGAGGTCTCATCAT-1	Fibroblasts
GGTGAGGTCTTAAGTG-1	Fibroblasts
GGTGAGGTCTTGTCTG-1	Pericytes
GGTGCTGGTGGTTCCC-1	Cardiomyocytes
GGTGCTGGTTAGACCA-1	Endothelial
GGTGCTGGTTATAGCG-1	Fibroblasts
GGTGCTGGTTCCTGTG-1	Cardiomyocytes
GGTGCTGGTTTGCAGA-1	Fibroblasts
GGTGCTTCAGTTGCGT-1	Cardiomyocytes
GGTGTCCAGCACAGGG-1	Pericytes
GGTGTCCAGGTAACGA-1	Cardiomyocytes
GGTGTGACAGAAACGT-1	Endothelial
GGTGTTGTCAACCAAC-1	Cardiomyocytes
GGTGTTGTCGTCCTTA-1	Cardiomyocytes
GGTTAATGTCACAGAC-1	Endothelial
GGTTAATGTCACGGAT-1	Endothelial
GGTTAATGTGATCATG-1	Cardiomyocytes
GGTTACCCAATGAGGT-1	Fibroblasts
GGTTACTAGAACCTAC-1	Cardiomyocytes
GGTTACTAGTTTCCTG-1	Pericytes
GGTTAGCGTGGATTGC-1	Endothelial
GGTTATATCATTATGG-1	Fibroblasts
GGTTATATCCACCCTG-1	Cardiomyocytes
GGTTATATCTTAGTGA-1	Cardiomyocytes
GGTTATGGTAACTACG-1	Cardiomyocytes
GGTTATGGTTACTTCA-1	Cardiomyocytes
GGTTATGGTTGTTGTC-1	Endothelial
GGTTCCCGTAGGATTT-1	Fibroblasts
GGTTCTTGTACCGTAA-1	Fibroblasts
GGTTCTTGTTACAAAC-1	Pericytes
GGTTCTTGTTCCTGTG-1	Fibroblasts
GGTTCTTGTTTAACCC-1	Cardiomyocytes
GGTTGAGCAAGGTGGC-1	Cardiomyocytes
GGTTGAGCACATAGCC-1	Endothelial
GGTTGAGCAGAGAGCC-1	Myeloid
GGTTGCATCATGTCAA-1	Pericytes
GGTTGCATCCTAAATG-1	Endothelial
GGTTGCTCAATGAAGC-1	Smooth.muscle
GGTTGGTGTATTCGTC-1	Cardiomyocytes
GGTTGGTGTTTATTCG-1	Endothelial
GGTTTAATCAAGCGCC-1	Cardiomyocytes
GGTTTAATCAGCCAAT-1	Fibroblasts
GGTTTAATCATGTTTC-1	Endothelial
GGTTTAATCCCGTTGT-1	Endothelial
GGTTTAATCCCTCAAC-1	Cardiomyocytes
GGTTTCCTCAGGAAGC-1	Pericytes
GGTTTCCTCTTAGCCC-1	Neuronal
GGTTTCTGTCCTAAGA-1	Smooth.muscle
GTAAAGCCACCAACCG-1	Cardiomyocytes
GTAAAGCCATCAATCG-1	Cardiomyocytes
GTAAAGCCATGTCAGC-1	Smooth.muscle
GTAAAGCCATTGCGGT-1	Fibroblasts
GTAAGCAAGCTTGCTC-1	Cardiomyocytes
GTAAGCAAGGACCTCA-1	Fibroblasts
GTAAGCAAGGAGCACG-1	Cardiomyocytes
GTAAGCAAGGGATGAC-1	Cardiomyocytes
GTAAGCGCACTAGCGT-1	Cardiomyocytes
GTAAGCGCATAATTGC-1	Cardiomyocytes
GTAAGGTCAGGTATTT-1	Fibroblasts
GTAATAGCATGTTGTG-1	Cardiomyocytes
GTACAATGTCTCAGCC-1	Cardiomyocytes
GTACAATGTGCGCATG-1	Pericytes
GTACAATGTTCAAGCA-1	Cardiomyocytes
GTACACCCACTTACAG-1	Cardiomyocytes
GTACACCCAGCAACCT-1	Cardiomyocytes
GTACACCCATGGCCCA-1	Fibroblasts
GTACCTTGTGGAGCAA-1	Fibroblasts
GTACTAATCAAGCGCC-1	Fibroblasts
GTACTAATCCGGTTGA-1	Smooth.muscle
GTACTAATCCTCCCTC-1	Fibroblasts
GTACTAATCCTGAATA-1	Fibroblasts
GTACTAATCGTTATCT-1	Endothelial
GTACTGGTCAGGAACA-1	Endothelial
GTACTGGTCCCTCGCA-1	Fibroblasts
GTACTTAAGCACAGAA-1	Cardiomyocytes
GTAGCCATCCTTTACG-1	Endothelial
GTAGCCATCTTAAGTG-1	Cardiomyocytes
GTAGCGCTCAATGACC-1	Endothelial
GTAGCGCTCACAGCGC-1	Cardiomyocytes
GTAGCTGTCAGCTAAC-1	Cardiomyocytes
GTAGCTGTCCTCAGTC-1	Cardiomyocytes
GTAGGAGGTGAAGCCT-1	Fibroblasts
GTAGGAGGTTAGAGCC-1	Endothelial
GTAGGATCACAACAAA-1	Fibroblasts
GTAGGATCACTGACTA-1	Endothelial
GTAGGATCATGTTTGG-1	Cardiomyocytes
GTAGGCGAGCGCATTG-1	Fibroblasts
GTAGGCGAGGTGAGAC-1	Fibroblasts
GTAGGCGAGTCTTGAA-1	Cardiomyocytes
GTAGGCGAGTGAACGA-1	Smooth.muscle
GTAGGTGCACAATGCC-1	Cardiomyocytes
GTAGGTGCAGGCATCT-1	Cardiomyocytes
GTAGTTATCAATCTCT-1	Fibroblasts
GTAGTTATCTTGTCCA-1	Fibroblasts
GTAGTTTCAAACCTTG-1	Myeloid
GTAGTTTCAGAGAGCC-1	Endothelial
GTATGTGGTCACAAAT-1	Cardiomyocytes
GTATGTGGTCTCACTG-1	Smooth.muscle
GTATGTGGTGCCGCAA-1	Endothelial
GTATGTGGTTAACACG-1	Cardiomyocytes
GTATGTTCATGAAGTA-1	Fibroblasts
GTATTCAAGTGTGATC-1	Cardiomyocytes
GTATTGATCATGCGTG-1	Endothelial
GTATTGCAGGCTAAGA-1	Cardiomyocytes
GTCAAACTCACCTGTC-1	Fibroblasts
GTCAGGCTCCAAGTTA-1	Fibroblasts
GTCAGGCTCCAGCACA-1	Fibroblasts
GTCAGGCTCTTGCATT-1	Endothelial
GTCATCACATTAGGCC-1	Cardiomyocytes
GTCATCCTCCCGAACA-1	Pericytes
GTCATGCCAGGTTATT-1	Cardiomyocytes
GTCATTAAGTCATTGA-1	Cardiomyocytes
GTCCAAGTCATGTGGT-1	Cardiomyocytes
GTCCAAGTCCGTGACA-1	Fibroblasts
GTCCAGGGTAATCCCT-1	Fibroblasts
GTCCAGGGTTGAGCCG-1	Pericytes
GTCCATTGTGGATTGC-1	Fibroblasts
GTCCGTAAGAGCAAGC-1	Endothelial
GTCCGTAAGGTGAGAC-1	Cardiomyocytes
GTCCGTAAGTTAGGCT-1	Cardiomyocytes
GTCCTAGAGGCTAGAA-1	Endothelial
GTCCTAGAGTAAGAAC-1	Cardiomyocytes
GTCCTAGAGTTATGTG-1	Endothelial
GTCCTCAGTTAGAGGG-1	Endothelial
GTCCTCCCAATAATGG-1	Endothelial
GTCCTCCCAGGCATCT-1	Smooth.muscle
GTCCTCCCAGGGAGCT-1	Cardiomyocytes
GTCGAAGCAAAGCGCA-1	Cardiomyocytes
GTCGAAGCACTGACTA-1	Endothelial
GTCGAGGAGTCAATCA-1	Fibroblasts
GTCGGTTCAATATGGA-1	Cardiomyocytes
GTCGGTTCACTATGGC-1	Cardiomyocytes
GTCTAACAGCTTAGCG-1	Fibroblasts
GTCTAACAGGGTGAAC-1	Cardiomyocytes
GTCTAGCCACAGCCTG-1	Cardiomyocytes
GTCTATCGTTTGTCTA-1	Myeloid
GTCTATGCAAGGGTTG-1	Cardiomyocytes
GTCTATGCACTAGGTC-1	Cardiomyocytes
GTCTCACTCAATCTCT-1	Endothelial
GTCTCACTCGCTCCAT-1	Cardiomyocytes
GTCTTGCTCGTTACTT-1	Cardiomyocytes
GTCTTGCTCTTAGGGT-1	Endothelial
GTCTTTAGTGCAATGC-1	Cardiomyocytes
GTCTTTAGTTCACCAT-1	Cardiomyocytes
GTCTTTGTCGATTCTT-1	Cardiomyocytes
GTGAACAAGCCTGGTA-1	Cardiomyocytes
GTGAACAAGCTTAACA-1	Pericytes
GTGAACAAGTTAGCCG-1	Cardiomyocytes
GTGAATCTCAATGTCA-1	Endothelial
GTGAATCTCGCACACA-1	Fibroblasts
GTGAATCTCGTTACAA-1	Fibroblasts
GTGAGCGAGGAGCAAC-1	Cardiomyocytes
GTGAGCGAGGCTAATC-1	Endothelial
GTGAGCGAGTGAGGGT-1	Cardiomyocytes
GTGATGAAGCACAGGG-1	Cardiomyocytes
GTGATGAAGCATCCAG-1	Pericytes
GTGATGAAGCTGGCTA-1	Cardiomyocytes
GTGATGAAGTAAGAAC-1	Cardiomyocytes
GTGCAAGCAATTGACT-1	Cardiomyocytes
GTGCAAGCATGTCAAT-1	Endothelial
GTGCATTAGAAACTGG-1	Endothelial
GTGCATTAGCCTTAAA-1	Fibroblasts
GTGCATTAGCTAATTG-1	Fibroblasts
GTGCCTTTCAGGCTAT-1	Cardiomyocytes
GTGCCTTTCCCGTTAC-1	Cardiomyocytes
GTGCCTTTCGCGCTAA-1	Smooth.muscle
GTGCCTTTCGGGATTT-1	Cardiomyocytes
GTGCCTTTCTCCATGC-1	Myeloid
GTGCGCAGTTGCATCT-1	Smooth.muscle
GTGCGCAGTTTAGCTC-1	Cardiomyocytes
GTGCGGTTCTCGCCCA-1	Smooth.muscle
GTGCTCAAGAGGAAGG-1	Endothelial
GTGCTCCGTCCTTAGT-1	Fibroblasts
GTGCTCCGTTGAGGTC-1	Smooth.muscle
GTGCTGATCCGCCAAA-1	Endothelial
GTGCTGATCCTTTACG-1	Fibroblasts
GTGCTGGGTAACAGGG-1	Cardiomyocytes
GTGCTGGGTAGGTTGC-1	Adipocytes
GTGCTGGGTCCGGTTC-1	Cardiomyocytes
GTGCTGGGTCGTTATC-1	Pericytes
GTGCTTACAGCTAACC-1	Myeloid
GTGCTTCTCAATGAGG-1	Pericytes
GTGCTTCTCATTATGG-1	Pericytes
GTGGACACAAATTCGT-1	Cardiomyocytes
GTGGACACAAATTGCT-1	Cardiomyocytes
GTGGACACAATGCCCG-1	Neuronal
GTGGACACACTTCACT-1	Fibroblasts
GTGGACACAGCACCAT-1	Cardiomyocytes
GTGGCTTCAGACAAAC-1	Pericytes
GTGGCTTCATGGCCCA-1	Cardiomyocytes
GTGGTTAGTAGCTAGC-1	Cardiomyocytes
GTGGTTAGTGATGGCT-1	Cardiomyocytes
GTGGTTAGTGGTGAGA-1	Cardiomyocytes
GTGTAACTCCTCAGCT-1	Cardiomyocytes
GTGTCCAAGCCTGATG-1	Endothelial
GTGTCCAAGCCTGGTA-1	Endothelial
GTGTCCAAGCTAATTG-1	Cardiomyocytes
GTGTCCAAGGTCCGTA-1	Adipocytes
GTGTGTTAGACAACAG-1	Cardiomyocytes
GTGTGTTAGGCGCTTA-1	Fibroblasts
GTGTGTTAGTAGCGGG-1	Endothelial
GTGTGTTAGTTGTCAA-1	Endothelial
GTGTTCCTCGGTTACG-1	Endothelial
GTTAAACGTAATGGAA-1	Fibroblasts
GTTAAACGTGGATGTC-1	Endothelial
GTTAACCAGAATCTCA-1	Cardiomyocytes
GTTAACCAGCTCGCTT-1	Adipocytes
GTTAACCAGGAACGCG-1	Fibroblasts
GTTAACCAGTCATCCC-1	Fibroblasts
GTTAACGGTTACTTGC-1	Cardiomyocytes
GTTAAGCTCGGGATTT-1	Fibroblasts
GTTAAGTGTAACGTGC-1	Fibroblasts
GTTAAGTGTGCGCAAT-1	Cardiomyocytes
GTTAAGTGTTTGCAGA-1	Cardiomyocytes
GTTAATGTCAAGGACA-1	Cardiomyocytes
GTTAATGTCGGTTACG-1	Fibroblasts
GTTACAGGTGGGAACA-1	Endothelial
GTTACAGGTGTGCACG-1	Cardiomyocytes
GTTACCTGTCGAAGTC-1	Cardiomyocytes
GTTACGCCAAACGCGA-1	Pericytes
GTTACGCCAAAGCGCA-1	Smooth.muscle
GTTACGCCAAATATCC-1	Fibroblasts
GTTACGTAGGTTACGT-1	Fibroblasts
GTTACTAAGGAGCATA-1	Endothelial
GTTACTAAGGCAACAA-1	Fibroblasts
GTTACTAAGGGATTAG-1	Cardiomyocytes
GTTACTAAGTTAACCA-1	Cardiomyocytes
GTTACTCGTCATAGAT-1	Fibroblasts
GTTACTCGTCCCGGAA-1	Endothelial
GTTAGACTCAAGTGAG-1	Fibroblasts
GTTAGACTCGCTATGG-1	Fibroblasts
GTTCACCTCCATCAGG-1	Cardiomyocytes
GTTCACCTCTAGCGAT-1	Endothelial
GTTCACCTCTTACTCG-1	Smooth.muscle
GTTCATTTCATGCTTT-1	Fibroblasts
GTTCATTTCTCACTAT-1	Cardiomyocytes
GTTCCCAGTTCGCTTG-1	Cardiomyocytes
GTTCCTGGTCGACTAA-1	Cardiomyocytes
GTTCCTGGTGTCCAGG-1	Fibroblasts
GTTCCTTCAAGGTAAC-1	Smooth.muscle
GTTCGCGCAGTAAGTA-1	Endothelial
GTTCGCGCATTATGAC-1	Endothelial
GTTCGCTTCACGCCAA-1	Cardiomyocytes
GTTCGCTTCCGCAAAT-1	Endothelial
GTTCGCTTCTTAGCGG-1	Cardiomyocytes
GTTCTCATCGTTACAA-1	Smooth.muscle
GTTCTTAGTCAAGTGC-1	Cardiomyocytes
GTTCTTGTCACCAATA-1	Endothelial
GTTCTTGTCATGAAGG-1	Cardiomyocytes
GTTCTTGTCTCACACC-1	Cardiomyocytes
GTTGCATAGGAGGCAT-1	Fibroblasts
GTTGCCCGTTAGCAGC-1	Endothelial
GTTGCTGAGGTCAAAG-1	Fibroblasts
GTTGCTGAGTAAGTCC-1	Endothelial
GTTGTGAGTTAGGACC-1	Myeloid
GTTGTTGCATAAGCAA-1	Pericytes
GTTGTTGCATCATGGC-1	Cardiomyocytes
GTTTAACCAACACTTG-1	Smooth.muscle
GTTTAACCACCTAAGC-1	Fibroblasts
GTTTAACCATTGTCCT-1	Fibroblasts
GTTTACCGTACGTTTC-1	Cardiomyocytes
GTTTACCGTCACAAAT-1	Endothelial
GTTTAGCAGCCTGGTA-1	Cardiomyocytes
GTTTAGCAGGGCCATC-1	Fibroblasts
GTTTATCTCAGGGCCT-1	Cardiomyocytes
GTTTATCTCATGAGCT-1	Fibroblasts
GTTTATCTCATGGCCA-1	Endothelial
GTTTCAGCACAGCCAT-1	Cardiomyocytes
GTTTCAGCATGGAGGC-1	Cardiomyocytes
GTTTCCTCAAAGCGCA-1	Pericytes
GTTTCTAGTAGTAAGA-1	Cardiomyocytes
GTTTCTAGTATGGTGC-1	Adipocytes
GTTTCTAGTATTGGAT-1	Endothelial
GTTTCTAGTCGCATAA-1	Fibroblasts
GTTTCTAGTCGTAATG-1	Fibroblasts
GTTTCTAGTTGCATCT-1	Endothelial
GTTTCTAGTTTCCGGC-1	Cardiomyocytes
GTTTCTAGTTTGGGCG-1	Fibroblasts
GTTTGCTGTAACCAGC-1	Cardiomyocytes
GTTTGCTGTCTAACCT-1	Endothelial
GTTTGCTGTTGCTGGG-1	Fibroblasts
GTTTGCTGTTTACCGT-1	Cardiomyocytes
GTTTGTAAGGTGCGGA-1	Fibroblasts
GTTTGTTTCATAATCG-1	Pericytes
GTTTGTTTCATCCTAT-1	Cardiomyocytes
TAAACAGCAATAACGA-1	Pericytes
TAACAAGCAGGCTACT-1	Cardiomyocytes
TAACCAGGTAACAGGG-1	Fibroblasts
TAACCAGGTTTAGCTC-1	Pericytes
TAACCGGTCATTAGGC-1	Cardiomyocytes
TAACCGGTCGACCTGA-1	Fibroblasts
TAAGCCAGTCCGTAGG-1	Fibroblasts
TAAGCCAGTGTCCAAA-1	Myeloid
TAAGCTATCACAGCCA-1	Endothelial
TAAGCTATCTCCATAT-1	Cardiomyocytes
TAAGCTGGTCAGTAAT-1	Cardiomyocytes
TAAGCTGGTGTTAAAC-1	Smooth.muscle
TAAGCTGGTTGGTGAC-1	Cardiomyocytes
TAAGCTGGTTTGGTTC-1	Cardiomyocytes
TAAGGACCAGCAACCT-1	Cardiomyocytes
TAAGGACCATAAGTCT-1	Cardiomyocytes
TAAGTGCTCCGCAAAT-1	Pericytes
TAAGTGCTCCGCACAA-1	Smooth.muscle
TAATCCGCAATGAGGT-1	Cardiomyocytes
TAATGCATCACAGACT-1	Fibroblasts
TAATGCATCCGCAAAT-1	Cardiomyocytes
TAATGCATCCTAAATG-1	Cardiomyocytes
TAATGCATCTGTAAGC-1	Fibroblasts
TAATGGACATAGCGGA-1	Smooth.muscle
TAATGGTGTGTCCAGG-1	Cardiomyocytes
TAATTGCCACATTAAC-1	Fibroblasts
TACAACATCCGCACAA-1	Endothelial
TACAACATCCTAATTC-1	Cardiomyocytes
TACAAGCTCAAGCCTG-1	Cardiomyocytes
TACAAGCTCATGCCTC-1	Fibroblasts
TACAAGCTCGGTTAGT-1	Myeloid
TACAATGTCCTCACTA-1	Smooth.muscle
TACAGCTAGCCAGTAT-1	Pericytes
TACAGCTAGGTCCGTA-1	Cardiomyocytes
TACAGCTAGTACCGCA-1	Fibroblasts
TACAGGTTCAAACTCA-1	Cardiomyocytes
TACAGGTTCAGAAACG-1	Fibroblasts
TACCAAATCTCCATGC-1	Cardiomyocytes
TACCAGGTCATCAGTA-1	Fibroblasts
TACCAGGTCATGCTAA-1	Cardiomyocytes
TACCAGGTCGTCCTTA-1	Fibroblasts
TACCAGGTCTTAAGTG-1	Fibroblasts
TACCCGGCATTTAAGC-1	Endothelial
TACCGCAAGCTGTCAG-1	Fibroblasts
TACCGTTGTTAACGAT-1	Fibroblasts
TACCGTTGTTACTAGG-1	Cardiomyocytes
TACCTCATCAATCTAG-1	Pericytes
TACCTCATCATTTGCT-1	Cardiomyocytes
TACCTCATCCGCAACA-1	Endothelial
TACCTGCTCCGCATGA-1	Cardiomyocytes
TACCTGCTCTTGACCC-1	Fibroblasts
TACCTGCTCTTGCAGG-1	Cardiomyocytes
TACCTTAGTGATCATG-1	Cardiomyocytes
TACCTTAGTGCAATGC-1	Fibroblasts
TACCTTAGTTTGGGTA-1	Endothelial
TACCTTTAGCCGCAGT-1	Endothelial
TACCTTTAGGTCTTGG-1	Endothelial
TACGCTTGTACCGAAC-1	Cardiomyocytes
TACGCTTGTCCCGAAG-1	Cardiomyocytes
TACGGATTCATTATGG-1	Cardiomyocytes
TACGGTTAGCTAAGTC-1	Fibroblasts
TACGGTTAGGTTACAC-1	Cardiomyocytes
TACGGTTAGTAATCCA-1	Cardiomyocytes
TACGGTTAGTTGCGTG-1	Fibroblasts
TACGTACAGCTCGCTT-1	Cardiomyocytes
TACGTACAGTATCGCG-1	Endothelial
TACGTTAAGGAAGCAC-1	Cardiomyocytes
TACGTTAAGGTTACGT-1	Cardiomyocytes
TACGTTAAGTTACCGG-1	Smooth.muscle
TACTCAAAGGCGGATG-1	Pericytes
TACTCGCTCGTGCTAG-1	Endothelial
TACTGACAGGGTGGAT-1	Fibroblasts
TACTGACAGTGAAGTG-1	Neuronal
TACTGAGGTCATCAAG-1	Cardiomyocytes
TACTGCACAATTTAGC-1	Cardiomyocytes
TACTGCACAGATTCAT-1	Endothelial
TACTGCACAGGTCCTG-1	Pericytes
TACTTCGTCCTGGTGA-1	Cardiomyocytes
TACTTCGTCGTCCTTA-1	Cardiomyocytes
TACTTGTTCAGGGCCT-1	Cardiomyocytes
TACTTGTTCGAGCAAA-1	Cardiomyocytes
TACTTGTTCGCATCCT-1	Cardiomyocytes
TAGAGCCGTTACTTGC-1	Cardiomyocytes
TAGCAGGCAAAGGCCA-1	Endothelial
TAGCATATCCCGTTAC-1	Endothelial
TAGCATATCTAATCTC-1	Cardiomyocytes
TAGCATATCTTGCTAT-1	Endothelial
TAGCCTCTCATCCTAT-1	Cardiomyocytes
TAGCCTGAGTCACCAG-1	Endothelial
TAGCCTTGTGCCTCAC-1	Fibroblasts
TAGCGCGGTTGGTTAG-1	Cardiomyocytes
TAGCGGACACTGACCG-1	Endothelial
TAGCGGACAGTTTACG-1	Cardiomyocytes
TAGCGGACAGTTTCTC-1	Pericytes
TAGCGGCTCTGTGCCT-1	Pericytes
TAGCTAATCGCTATGG-1	Fibroblasts
TAGCTAATCTAATCAG-1	Endothelial
TAGCTAATCTCACAAA-1	Endothelial
TAGCTAATCTCGCCCA-1	Endothelial
TAGCTAGGTGGTGAGA-1	Fibroblasts
TAGCTTGCAATCATGT-1	Cardiomyocytes
TAGCTTGCACCATATG-1	Cardiomyocytes
TAGGAACCAAACTGTT-1	Cardiomyocytes
TAGGAACCAGGGAGCT-1	Fibroblasts
TAGGCTAGTAATCACG-1	Smooth.muscle
TAGGCTAGTATGGTGC-1	Cardiomyocytes
TAGGCTAGTTGCACAA-1	Cardiomyocytes
TAGGCTGTCACGAATC-1	Cardiomyocytes
TAGGCTGTCAGCATTA-1	Endothelial
TAGGCTGTCCTTGAGG-1	Cardiomyocytes
TAGGCTGTCGGCTATG-1	Endothelial
TAGGCTGTCGTGCTTC-1	Smooth.muscle
TAGGGTTTCATGCATA-1	Fibroblasts
TAGGGTTTCCCGAACA-1	Endothelial
TAGGGTTTCCCTCAGT-1	Endothelial
TAGGGTTTCGCGACAC-1	Cardiomyocytes
TAGGGTTTCGTTAAGC-1	Cardiomyocytes
TAGGTGCGTTTGCGAA-1	Cardiomyocytes
TAGGTTATCCCGCCTA-1	Cardiomyocytes
TAGGTTATCTCACTCA-1	Cardiomyocytes
TAGGTTGGTGCAATAT-1	Adipocytes
TAGTAAGCACTTGTTC-1	Fibroblasts
TAGTAAGCAGGACACA-1	Endothelial
TAGTACGGTACCAGGT-1	Cardiomyocytes
TAGTACGGTGCTTTAC-1	Cardiomyocytes
TAGTACGGTTCACTGT-1	Cardiomyocytes
TAGTCAATCCTCATCA-1	Cardiomyocytes
TAGTGAGAGACACTTA-1	Cardiomyocytes
TAGTGAGAGGAACCGG-1	Cardiomyocytes
TAGTTGTCAAATACCT-1	Fibroblasts
TAGTTGTCAAGTTATC-1	Cardiomyocytes
TAGTTGTCACATGCTA-1	Fibroblasts
TATAACCCAACTAGAA-1	Cardiomyocytes
TATAACCCAGCCGCTA-1	Endothelial
TATAACCCAGGTTAAA-1	Adipocytes
TATAGCTCACCATATG-1	Fibroblasts
TATAGGTGTAACCAGC-1	Myeloid
TATAGGTGTCACAGAC-1	Endothelial
TATATCCTCAAAGGCA-1	Cardiomyocytes
TATATCCTCACATTGA-1	Cardiomyocytes
TATATCCTCCCGCCTA-1	Cardiomyocytes
TATATCCTCGAAGCGG-1	Adipocytes
TATATCCTCGGCTATG-1	Cardiomyocytes
TATCACAAGCATTTCT-1	Cardiomyocytes
TATCACAAGGCCATCA-1	Cardiomyocytes
TATCACAAGGTAAGCA-1	Cardiomyocytes
TATCACAAGTTATCCT-1	Cardiomyocytes
TATCACAAGTTTGTCT-1	Cardiomyocytes
TATCCAGCAGCCTTGG-1	Fibroblasts
TATCCAGCATTGCGAC-1	Cardiomyocytes
TATCCGGAGACACTTA-1	Cardiomyocytes
TATCGAGGTAATGGAA-1	Endothelial
TATCGAGGTCATCAAG-1	Endothelial
TATCGAGGTGAGAAAC-1	Cardiomyocytes
TATCGAGGTTACAAAC-1	Fibroblasts
TATCGCACATTCCTCG-1	Cardiomyocytes
TATCGCGAGCTTCTCA-1	Cardiomyocytes
TATCGCGAGGTAAGGC-1	Neuronal
TATCGCGAGTTTGGTA-1	Endothelial
TATGAAGCAACAACAA-1	Cardiomyocytes
TATGAAGCAATTAGGA-1	Fibroblasts
TATGAAGCATATAACC-1	Cardiomyocytes
TATGACATCAAACACC-1	Fibroblasts
TATGACTCAAATACCT-1	Endothelial
TATGACTCAAGGATTA-1	Cardiomyocytes
TATGACTCAGCCTGCA-1	Myeloid
TATGACTCAGGATGGC-1	Cardiomyocytes
TATGCATCACAGCCTG-1	Pericytes
TATGCATCAGAGGCTA-1	Endothelial
TATGCATCAGCATTAT-1	Pericytes
TATGGATGTCGACTAA-1	Cardiomyocytes
TATGGATGTTTAAAGC-1	Fibroblasts
TATGGCCCAGCACGAA-1	Fibroblasts
TATGGCCCAGCTAACC-1	Fibroblasts
TATGGCCCATAGTCAT-1	Cardiomyocytes
TATGGCCCATCACAGC-1	Neuronal
TATGGCCCATCTAGCA-1	Cardiomyocytes
TATGGGCGTCCCGAAG-1	Cardiomyocytes
TATGGGCGTGTTGTAG-1	Cardiomyocytes
TATGGGCGTTTATGGG-1	Cardiomyocytes
TATGGTCAGCTACTGG-1	Cardiomyocytes
TATTAGCCAAACGGGC-1	Endothelial
TATTAGGTCCGCTAGA-1	Fibroblasts
TATTAGGTCCTCATGC-1	Pericytes
TATTCGTTCAAAGGCA-1	Endothelial
TATTCGTTCAACCAAC-1	Pericytes
TATTCGTTCATTAGCA-1	Cardiomyocytes
TATTCGTTCCATAATG-1	Cardiomyocytes
TATTCGTTCGCTAGCA-1	Cardiomyocytes
TATTCGTTCTGGCAAT-1	Endothelial
TATTCGTTCTTTGTAC-1	Fibroblasts
TATTGACCAGTAAGTA-1	Fibroblasts
TATTGACCAGTCTAGC-1	Cardiomyocytes
TATTGACCATAGCTTG-1	Endothelial
TATTTGCTCCTAAGGT-1	Cardiomyocytes
TATTTGCTCTCAATGA-1	Cardiomyocytes
TATTTGGAGGCCTGGT-1	Pericytes
TCAAACCAGGGTTATC-1	Fibroblasts
TCAACAATCTCATCAT-1	Cardiomyocytes
TCAAGACTCACGCGGT-1	Cardiomyocytes
TCAAGACTCCTTAGTT-1	Fibroblasts
TCAAGACTCGATAACC-1	Cardiomyocytes
TCAAGACTCGCGCTAA-1	Cardiomyocytes
TCAAGCTAGGCTATGT-1	Fibroblasts
TCAAGCTAGGTGAGAC-1	Fibroblasts
TCAAGCTAGTTTGCGG-1	Fibroblasts
TCAAGGTTCGTTTCTG-1	Fibroblasts
TCAAGTATCCGGCTAA-1	Endothelial
TCAATCGCAATCGCAC-1	Myeloid
TCAATCGCACAAAGGT-1	Smooth.muscle
TCACATAAGTTTGGTA-1	Cardiomyocytes
TCACCGGCACAGAACG-1	Cardiomyocytes
TCACCTCAGCTCAAAC-1	Endothelial
TCACCTCAGCTCCTTA-1	Endothelial
TCACCTCAGGGATGCG-1	Fibroblasts
TCACCTGGTGGAGCAA-1	Fibroblasts
TCAGCAAGTACCAGGT-1	Myeloid
TCAGCAAGTGAACAAA-1	Myeloid
TCAGCAAGTTTATCTG-1	Fibroblasts
TCAGCCTTCATAGACC-1	Smooth.muscle
TCAGCGATCATGAGCT-1	Endothelial
TCAGGAGCAGACAAAC-1	Fibroblasts
TCAGGTCCATAGGCGA-1	Fibroblasts
TCAGGTTAGCCTCTCG-1	Cardiomyocytes
TCAGGTTAGCTTTGTT-1	Cardiomyocytes
TCAGGTTAGGAAGTAT-1	Fibroblasts
TCAGGTTAGTGATTCA-1	Pericytes
TCAGTAATCAAGCGCC-1	Cardiomyocytes
TCAGTAGGTCTTTGAC-1	Endothelial
TCAGTAGGTGTGAGAG-1	Cardiomyocytes
TCAGTGAGTTACTTGC-1	Fibroblasts
TCAGTGAGTTTCCTCC-1	Cardiomyocytes
TCATAACCAATGCCCG-1	Cardiomyocytes
TCATAACCATAGCGAG-1	Pericytes
TCATACTTCCTTGTTG-1	Endothelial
TCATACTTCGGCTATG-1	Cardiomyocytes
TCATCCATCTTTGAGA-1	Cardiomyocytes
TCATGAGGTCCTTCTC-1	Fibroblasts
TCATGAGGTTTGTTGC-1	Endothelial
TCATGCCTCACTAAGC-1	Endothelial
TCATGCCTCCATAAGC-1	Cardiomyocytes
TCATGCCTCCGGAACC-1	Smooth.muscle
TCATGCCTCGCAACAT-1	Neuronal
TCATGCCTCTCAATTC-1	Endothelial
TCATGTTTCAAACACC-1	Endothelial
TCATGTTTCCCGTTAC-1	Cardiomyocytes
TCATGTTTCGTGCTTC-1	Fibroblasts
TCATGTTTCGTTAGCG-1	Endothelial
TCATTACTCTATGACA-1	Cardiomyocytes
TCATTGCGTCAGGAAG-1	Cardiomyocytes
TCATTGCGTTAGAGCC-1	Myeloid
TCATTTGGTCACACCC-1	Fibroblasts
TCCAGCAAGAGCCGCT-1	Cardiomyocytes
TCCAGGATCCCTGACT-1	Pericytes
TCCAGGATCTAATCAG-1	Cardiomyocytes
TCCAGGTCACTCGCTC-1	Smooth.muscle
TCCAGGTCAGTCTAGC-1	Cardiomyocytes
TCCAGGTCAGTTATGT-1	Endothelial
TCCATAAAGGTGCTGC-1	Cardiomyocytes
TCCATAAAGTCAATCA-1	Fibroblasts
TCCATAAAGTCATTGA-1	Fibroblasts
TCCATATTCAGGAACA-1	Pericytes
TCCATATTCATTACAG-1	Cardiomyocytes
TCCATATTCGGCTAGC-1	Endothelial
TCCATCATCCCTCGCA-1	Fibroblasts
TCCATTGTCCTCGATC-1	Endothelial
TCCCGGACAATACTGT-1	Cardiomyocytes
TCCCGGACAGTTTCTC-1	Endothelial
TCCCGGACATAGCTTG-1	Fibroblasts
TCCCGTTAGAATCTCA-1	Endothelial
TCCCTGGTCATGGTGT-1	Endothelial
TCCCTGGTCCGGTTGA-1	Cardiomyocytes
TCCCTGGTCCTGATTT-1	Endothelial
TCCGCCATCCCGAAGC-1	Pericytes
TCCGGAATCATGGTGT-1	Endothelial
TCCTAGTGTGTTTGTC-1	Cardiomyocytes
TCCTCAATCAGCACCA-1	Cardiomyocytes
TCCTCACAGCTCGCTT-1	Cardiomyocytes
TCCTCACAGTCCTTCA-1	Cardiomyocytes
TCCTCACAGTTCCTGC-1	Neuronal
TCCTCTAAGAGAAGGG-1	Myeloid
TCCTCTAAGCATTATG-1	Cardiomyocytes
TCCTCTAAGTATGTGC-1	Fibroblasts
TCCTGGTTCAATAGCC-1	Cardiomyocytes
TCCTGTTCACAGCCAT-1	Cardiomyocytes
TCCTTAGTCTAATTGG-1	Endothelial
TCCTTCAAGATGGACA-1	Endothelial
TCCTTCAAGCCTAATA-1	Endothelial
TCCTTGCAGAAAGGAA-1	Cardiomyocytes
TCCTTGCAGCAAGGGT-1	Cardiomyocytes
TCCTTGCAGTGTGATC-1	Cardiomyocytes
TCCTTTACAACTAGAA-1	Fibroblasts
TCCTTTACAGTCTATG-1	Endothelial
TCGACAAGTTGTTGCT-1	Pericytes
TCGATTAAGCACGATT-1	Pericytes
TCGATTAAGCGAGGTG-1	Fibroblasts
TCGCATTGTTGCACAA-1	Cardiomyocytes
TCGCCCATCATGAAGG-1	Fibroblasts
TCGCCCATCCCTCTAA-1	Cardiomyocytes
TCGCCCATCGCTCCAT-1	Endothelial
TCGCGAGGTTTAGCTC-1	Cardiomyocytes
TCGCGAGGTTTATCGC-1	Endothelial
TCGCGCACATTGTTGG-1	Endothelial
TCGCTAACAAGGGTTG-1	Endothelial
TCGCTAACACATAACT-1	Neuronal
TCGCTAACAGATTCAT-1	Endothelial
TCGGTTACAAGGCCAA-1	Cardiomyocytes
TCGGTTCTCGCTAAAC-1	Cardiomyocytes
TCGGTTTGTATTTGGG-1	Endothelial
TCGTAATCAAACCTTG-1	Fibroblasts
TCGTAATCAACCGCCA-1	Cardiomyocytes
TCGTAATCACAAAGCG-1	Cardiomyocytes
TCGTCAACAATGAAGC-1	Fibroblasts
TCGTGCTTCTGTGCCT-1	Cardiomyocytes
TCGTTAAAGAACCTAC-1	Endothelial
TCGTTACGTAGCTGCG-1	Endothelial
TCGTTAGCATAAGTTC-1	Cardiomyocytes
TCTAAGGGTTACGCAA-1	Fibroblasts
TCTAATCTCATGGCCA-1	Endothelial
TCTACCTCAAGGCCAA-1	Fibroblasts
TCTAGCACACAAAGGT-1	Pericytes
TCTAGCACACAATGTT-1	Cardiomyocytes
TCTAGCACATAAGGAC-1	Fibroblasts
TCTAGCACATAGCGGA-1	Cardiomyocytes
TCTAGCACATGTCAGC-1	Cardiomyocytes
TCTAGCCTCCCGCATT-1	Cardiomyocytes
TCTAGCCTCCGGGACT-1	Cardiomyocytes
TCTAGCCTCCTTCTAG-1	Fibroblasts
TCTAGCCTCGATCAGT-1	Adipocytes
TCTAGCCTCGCAGGCT-1	Cardiomyocytes
TCTAGCGAGTAAACCC-1	Cardiomyocytes
TCTAGCGAGTAACTCA-1	Cardiomyocytes
TCTATGTTCGTAATCA-1	Cardiomyocytes
TCTATGTTCTGTAAGC-1	Cardiomyocytes
TCTATGTTCTTGGACG-1	Endothelial
TCTCAAGCACTTAACG-1	Cardiomyocytes
TCTCAATTCATGACCG-1	Cardiomyocytes
TCTCACCAGGCTACTG-1	Cardiomyocytes
TCTCGCCCAACCTGGT-1	Endothelial
TCTCGCCCAATGCCCG-1	Cardiomyocytes
TCTCGCCCATACTCCT-1	Fibroblasts
TCTCGCCCATAGCTGC-1	Cardiomyocytes
TCTCGCCCATTGACAT-1	Cardiomyocytes
TCTGTGACAATGAAGC-1	Cardiomyocytes
TCTGTGACATAGCGGA-1	Cardiomyocytes
TCTTAGTTCGTTAGTA-1	Pericytes
TCTTCAAGTAAACAAG-1	Cardiomyocytes
TCTTCAAGTACCGTAA-1	Cardiomyocytes
TCTTGACGTAACGGGA-1	Endothelial
TCTTGACGTAATGACT-1	Cardiomyocytes
TCTTGACGTGAGAAAC-1	Cardiomyocytes
TCTTGTCCAACAACAA-1	Cardiomyocytes
TCTTGTCCACCGGTAT-1	Cardiomyocytes
TCTTGTCCACTAAATC-1	Fibroblasts
TCTTTGTAGCAGCTAT-1	Cardiomyocytes
TCTTTGTAGGCCAATT-1	Cardiomyocytes
TGAAACTGTCCTCCAA-1	Cardiomyocytes
TGAAACTGTGTGTCCC-1	Cardiomyocytes
TGAAACTGTTGTTGTC-1	Endothelial
TGAACAGAGAATGACG-1	Endothelial
TGAACAGAGTGAACCT-1	Pericytes
TGAAGCAAGATTGAGG-1	Fibroblasts
TGAAGCAAGCGATAAG-1	Smooth.muscle
TGAAGCAAGGCGGATG-1	Endothelial
TGAAGGATCCCGTTAC-1	Endothelial
TGAAGGATCGTCATTT-1	Pericytes
TGAAGGATCTCCTCTT-1	Fibroblasts
TGACCTTGTACCGTAA-1	Cardiomyocytes
TGACCTTGTGATGAAA-1	Pericytes
TGACCTTGTTAGCTGA-1	Cardiomyocytes
TGACTCCTCCGGAACC-1	Endothelial
TGACTTAAGTCGCTAG-1	Cardiomyocytes
TGACTTCGTCATCATC-1	Fibroblasts
TGAGAACCACTTACAG-1	Cardiomyocytes
TGAGCAAAGGAACCAA-1	Cardiomyocytes
TGAGCACGTCAAGTGC-1	Fibroblasts
TGAGCACGTCATAGAT-1	Cardiomyocytes
TGAGCCGGTAACGTGC-1	Pericytes
TGAGCCGGTATTGAGT-1	Fibroblasts
TGAGCTTAGGAACACA-1	Fibroblasts
TGAGCTTAGGAAGCAC-1	Endothelial
TGAGGAGGTAAATTGC-1	Cardiomyocytes
TGAGGAGGTACTTAGG-1	Fibroblasts
TGAGGCACAGCATGGA-1	Cardiomyocytes
TGAGGGCCAAACAACA-1	Endothelial
TGAGGGCCACCGTTCC-1	Endothelial
TGAGGGCCAGAACCGA-1	Cardiomyocytes
TGAGGGCCAGCACGAA-1	Fibroblasts
TGAGGGCCATTATGGT-1	Cardiomyocytes
TGATCACAGGCGCACT-1	Cardiomyocytes
TGATCACAGGCGCATC-1	Cardiomyocytes
TGATCACAGTTCCCAC-1	Endothelial
TGATCCTGTAGTTAAC-1	Cardiomyocytes
TGATCGAGTTTATTCG-1	Cardiomyocytes
TGATGAACATGTTGGC-1	Endothelial
TGATTAGTCCCATAGG-1	Adipocytes
TGATTAGTCCTGAATA-1	Pericytes
TGATTCAAGTTAGCCG-1	Endothelial
TGATTGCAGGTTACGT-1	Fibroblasts
TGATTGCAGTGGCGGA-1	Pericytes
TGATTGCAGTTTCCTG-1	Cardiomyocytes
TGCAAGCGTTCACTGT-1	Cardiomyocytes
TGCAATATCTCACTCA-1	Pericytes
TGCACTTGTGCATTTC-1	Cardiomyocytes
TGCACTTGTGTTCCCA-1	Cardiomyocytes
TGCAGGCTCACAGCCA-1	Smooth.muscle
TGCATCCTCATTACAG-1	Cardiomyocytes
TGCATCCTCCTAAGTA-1	Cardiomyocytes
TGCATCCTCGGTCAAT-1	Endothelial
TGCATCCTCGGTTTGG-1	Endothelial
TGCATTAAGGAACGGT-1	Endothelial
TGCATTAAGTCTGGGC-1	Cardiomyocytes
TGCCATTGTATTGCAG-1	Endothelial
TGCCGGTAGCTACTGG-1	Cardiomyocytes
TGCCGGTAGTAGGCGG-1	Fibroblasts
TGCCTGTTCACTCAAA-1	Cardiomyocytes
TGCCTGTTCCCGTTAC-1	Fibroblasts
TGCCTGTTCTTAATGG-1	Fibroblasts
TGCGATTAGCTGTCAG-1	Cardiomyocytes
TGCGCAGGTATTCGTC-1	Cardiomyocytes
TGCGCAGGTTGACTTC-1	Adipocytes
TGCGCGAGTCAAGTAT-1	Endothelial
TGCGCGAGTCCTAGTT-1	Cardiomyocytes
TGCGCGAGTGGTTCTT-1	Fibroblasts
TGCGCGAGTTCCGGCT-1	Fibroblasts
TGCGGTTCACAGACTC-1	Fibroblasts
TGCGGTTCAGATTCAT-1	Cardiomyocytes
TGCGGTTCATAATCAC-1	Endothelial
TGCTAACAGGACTAAG-1	Fibroblasts
TGCTAGCCAACTAGAA-1	Cardiomyocytes
TGCTAGCCAGATTCAT-1	Cardiomyocytes
TGCTATGCACAATGCC-1	Cardiomyocytes
TGCTCAACACAGGGAC-1	Pericytes
TGCTCAACAGTTAAAG-1	Cardiomyocytes
TGCTCAACATAGCTGC-1	Cardiomyocytes
TGCTCCGTCAGGATGA-1	Fibroblasts
TGCTCCGTCTCCTCTT-1	Cardiomyocytes
TGCTCTCAGTATTGCA-1	Fibroblasts
TGCTGGATCCACCCTG-1	Cardiomyocytes
TGCTTAAAGCCAGTAT-1	Cardiomyocytes
TGCTTCATCATCCTGC-1	Fibroblasts
TGCTTCATCATTAGCA-1	Fibroblasts
TGCTTCATCTAAGTGC-1	Endothelial
TGCTTGCTCAGGGCCT-1	Cardiomyocytes
TGCTTGTGTCGAAGTC-1	Cardiomyocytes
TGCTTGTGTGCACGCA-1	Cardiomyocytes
TGCTTTAGTGTCCAAA-1	Endothelial
TGCTTTAGTTGTTGGA-1	Cardiomyocytes
TGGACAAAGCAATAGG-1	Cardiomyocytes
TGGACCGGTGGTTCTT-1	Endothelial
TGGACCGGTGTTTCAC-1	Endothelial
TGGACCGGTTAGCCAA-1	Smooth.muscle
TGGACGGAGAACAAGT-1	Adipocytes
TGGACGGAGCTATGAC-1	Cardiomyocytes
TGGACGGAGGTTACAC-1	Endothelial
TGGACGGAGGTTTACA-1	Fibroblasts
TGGACTAGTATTGAGT-1	Cardiomyocytes
TGGACTAGTTAGCTGA-1	Cardiomyocytes
TGGACTAGTTGTCCAT-1	Cardiomyocytes
TGGATTCAGCATTATG-1	Smooth.muscle
TGGATTCAGGTCGATT-1	Cardiomyocytes
TGGATTCAGTAAGTCC-1	Cardiomyocytes
TGGATTGGTCCTAGTT-1	Endothelial
TGGATTGGTGATCAGC-1	Endothelial
TGGATTGGTGCGCAAT-1	Cardiomyocytes
TGGCCATCACAATGCC-1	Endothelial
TGGCCATCACATTAAC-1	Endothelial
TGGCCATCAGTAAGTA-1	Cardiomyocytes
TGGCCTGCAACAACAA-1	Cardiomyocytes
TGGCCTTTCGTTAAGC-1	Endothelial
TGGCCTTTCGTTAGTA-1	Cardiomyocytes
TGGCCTTTCTTGCAAA-1	Myeloid
TGGCTATAGGCAAGTA-1	Fibroblasts
TGGCTTTGTCTAGCTT-1	Cardiomyocytes
TGGTAAACAAATTGCT-1	Cardiomyocytes
TGGTAAACAATAATGG-1	Pericytes
TGGTCAAGTGAGACTC-1	Fibroblasts
TGGTCAAGTGATTACG-1	Endothelial
TGGTCAAGTGGATTAT-1	Cardiomyocytes
TGGTCAGTCATTGTTC-1	Fibroblasts
TGGTCAGTCGTTACTT-1	Cardiomyocytes
TGGTCATAGAGAGCCG-1	Pericytes
TGGTCATAGCCGCAGT-1	Endothelial
TGGTCATAGCCTAATA-1	Myeloid
TGGTCATAGGATAAAC-1	Endothelial
TGGTCATAGTTGGGCC-1	Cardiomyocytes
TGGTCCTTCCTTAGGG-1	Smooth.muscle
TGGTGATTCCGCCTAT-1	Cardiomyocytes
TGGTGCATCATTGACA-1	Pericytes
TGGTGCATCGGTTTGG-1	Fibroblasts
TGGTTAATCGTAATCA-1	Cardiomyocytes
TGGTTCCTCAAACACC-1	Fibroblasts
TGGTTCCTCTAGCGTG-1	Adipocytes
TGGTTCTGTTATGTGG-1	Endothelial
TGGTTCTGTTGCACGG-1	Cardiomyocytes
TGGTTGAGTGAAACAA-1	Pericytes
TGTAAAGCAGCCAGTT-1	Fibroblasts
TGTAAGCTCAAGTGTC-1	Cardiomyocytes
TGTAAGTGTCGTAATG-1	Fibroblasts
TGTAAGTGTGAGCACT-1	Cardiomyocytes
TGTAAGTGTTGAAGCC-1	Myeloid
TGTAAGTGTTTAAAGC-1	Cardiomyocytes
TGTAATGTCTCATCAT-1	Fibroblasts
TGTATCCGTAAGGTTT-1	Smooth.muscle
TGTATCCGTGACATGC-1	Cardiomyocytes
TGTATCCGTTAGGCGT-1	Endothelial
TGTATCCGTTCAAGCA-1	Fibroblasts
TGTATCCGTTCGGTAA-1	Fibroblasts
TGTATCGCAACATAAG-1	Cardiomyocytes
TGTATCGCAGCTAATT-1	Endothelial
TGTCAATCACGGTTTA-1	Cardiomyocytes
TGTCAATCAGAGGCTA-1	Fibroblasts
TGTCAATCAGGTTACC-1	Cardiomyocytes
TGTCAATCATAGTCAT-1	Fibroblasts
TGTCAATCATGCATAT-1	Cardiomyocytes
TGTCAGTAGATAAAGC-1	Endothelial
TGTCAGTAGATGCCTG-1	Endothelial
TGTCAGTAGGAGCATA-1	Myeloid
TGTCAGTAGGTGAGAC-1	Cardiomyocytes
TGTCATAAGCAAGATG-1	Cardiomyocytes
TGTCATAAGGACCTGC-1	Pericytes
TGTCATAAGTCAGTAC-1	Pericytes
TGTCATAAGTTTGCGG-1	Cardiomyocytes
TGTCCTGGTCACAGCG-1	Pericytes
TGTCCTGGTGATTACG-1	Cardiomyocytes
TGTCCTTCACAAAGGT-1	Endothelial
TGTCCTTCACCTACGG-1	Pericytes
TGTCCTTCACTGACTA-1	Endothelial
TGTCCTTCATTAAAGG-1	Cardiomyocytes
TGTCCTTCATTGTCCT-1	Cardiomyocytes
TGTGAAACACATACTG-1	Cardiomyocytes
TGTGAAACATGACTAT-1	Cardiomyocytes
TGTGATCAGCACAGAA-1	Fibroblasts
TGTGATCAGTGTTGTA-1	Endothelial
TGTGCAAGTTCCGGCT-1	Cardiomyocytes
TGTGCAAGTTGCGCGA-1	Cardiomyocytes
TGTGCGGGTAGGATCC-1	Endothelial
TGTGCGGGTGTGAGAG-1	Endothelial
TGTGGAGCACAGAACG-1	Fibroblasts
TGTGGAGCATCCAGGT-1	Endothelial
TGTGGCCAGAGAGGCT-1	Cardiomyocytes
TGTGGCCAGAGGGACT-1	Cardiomyocytes
TGTGGCGGTGGATTAT-1	Endothelial
TGTGGCTCATCATGTG-1	Cardiomyocytes
TGTGGCTCATCTAGCA-1	Endothelial
TGTGGCTCATGCTTAG-1	Cardiomyocytes
TGTGTTAAGCACCACA-1	Myeloid
TGTTACTTCAATCTCT-1	Pericytes
TGTTACTTCCTGGCTT-1	Fibroblasts
TGTTACTTCTTAGCGG-1	Cardiomyocytes
TGTTAGCAGGGCTAAA-1	Cardiomyocytes
TGTTATGAGAGCCGGA-1	Endothelial
TGTTCATTCAAGCCTG-1	Smooth.muscle
TGTTCATTCCAAACAC-1	Fibroblasts
TGTTCCTCATTATGAC-1	Pericytes
TGTTGCACACAATTAC-1	Cardiomyocytes
TGTTGCACAGCAGGTA-1	Cardiomyocytes
TGTTGGCCACAAGCCT-1	Cardiomyocytes
TGTTGGCCAGCTAATT-1	Pericytes
TGTTGGCCATGCAACC-1	Cardiomyocytes
TGTTGTAAGCGATACT-1	Endothelial
TGTTGTAAGCTAATTG-1	Cardiomyocytes
TGTTTGTTCATCCTAT-1	Cardiomyocytes
TTAAAGGCATTGTGAT-1	Endothelial
TTAACCAAGTAGGATG-1	Smooth.muscle
TTAAGCCAGGTGAAGC-1	Cardiomyocytes
TTAAGCCAGTTGCCTC-1	Cardiomyocytes
TTAAGGACACCTCACC-1	Cardiomyocytes
TTAAGTGTCATGTCAA-1	Endothelial
TTAATCGAGGCATGAA-1	Cardiomyocytes
TTAATCGAGTGACCTG-1	Fibroblasts
TTACACCGTAAGCACC-1	Cardiomyocytes
TTACAGCAGCAAGGGT-1	Neuronal
TTACAGCAGCCTAATA-1	Fibroblasts
TTACAGCAGCCTGTTC-1	Cardiomyocytes
TTACAGCAGCGGGCAA-1	Cardiomyocytes
TTACCGTGTATTGGTG-1	Pericytes
TTACCGTGTGCTCCGT-1	Cardiomyocytes
TTACCGTGTTACAACG-1	Cardiomyocytes
TTACCGTGTTAGGATT-1	Smooth.muscle
TTACCGTGTTGTGACA-1	Cardiomyocytes
TTACCTGTCAGAAACG-1	Cardiomyocytes
TTACCTGTCATCACTT-1	Cardiomyocytes
TTACCTGTCCTCATGC-1	Smooth.muscle
TTACCTGTCTACCTGC-1	Cardiomyocytes
TTACCTGTCTGCAAGT-1	Cardiomyocytes
TTACGTTTCTCATCAT-1	Cardiomyocytes
TTACGTTTCTGTGCAG-1	Cardiomyocytes
TTACGTTTCTTTAGGA-1	Cardiomyocytes
TTAGAAGCAAGGATTA-1	Cardiomyocytes
TTAGAAGCAATATGGA-1	Cardiomyocytes
TTAGAAGCAGCTAATT-1	Cardiomyocytes
TTAGACTCACACTAAT-1	Cardiomyocytes
TTAGACTCATTAAGTC-1	Cardiomyocytes
TTAGCAATCCCATAGG-1	Fibroblasts
TTAGCAATCCGGTTGA-1	Cardiomyocytes
TTAGCAGGTCAATACG-1	Cardiomyocytes
TTAGCAGGTTAGGATT-1	Cardiomyocytes
TTAGCGGTCATCCTAT-1	Endothelial
TTAGGCTAGAATCTCA-1	Endothelial
TTAGGCTAGCTTCCCG-1	Cardiomyocytes
TTAGGCTAGGAGCACG-1	Fibroblasts
TTAGGCTAGGGCCATC-1	Cardiomyocytes
TTAGGCTAGGTGTTAC-1	Cardiomyocytes
TTAGGCTAGTCCTTCA-1	Pericytes
TTAGGCTAGTGAAGTG-1	Endothelial
TTAGGCTAGTGCACGC-1	Endothelial
TTAGGCTAGTTAGCCG-1	Endothelial
TTATAGCCAAATGCCC-1	Cardiomyocytes
TTATCCTAGCATGTTA-1	Fibroblasts
TTATCCTAGCCGCAGT-1	Fibroblasts
TTATCCTAGCGGGCAA-1	Endothelial
TTATCCTAGGATCCGC-1	Cardiomyocytes
TTATCCTAGGTCCACA-1	Pericytes
TTATGCGCAGTAATAG-1	Cardiomyocytes
TTATTGCTCCAAACAC-1	Pericytes
TTATTGCTCCAAATCA-1	Endothelial
TTCAACCGTCATCCTG-1	Smooth.muscle
TTCAACCGTGAGAAAC-1	Pericytes
TTCACTGTCGCTTCTA-1	Endothelial
TTCACTGTCTTAATGG-1	Cardiomyocytes
TTCAGCACATAGACTT-1	Fibroblasts
TTCAGTTTCTGTTCAT-1	Endothelial
TTCATTCAGCGATACT-1	Cardiomyocytes
TTCATTCAGGAGGCAT-1	Endothelial
TTCCCACAGCGGTTAT-1	Endothelial
TTCCCGCCAAGGTAAC-1	Pericytes
TTCCTCAAGCTCATAA-1	Cardiomyocytes
TTCCTTCTCAAACACC-1	Fibroblasts
TTCCTTGAGGGTCTAT-1	Endothelial
TTCGCAACAAGGTAAC-1	Cardiomyocytes
TTCGCAACACTGACCG-1	Cardiomyocytes
TTCGCAACAGCCAGAA-1	Smooth.muscle
TTCGGTACACATTGCA-1	Fibroblasts
TTCGTGCTCCGTAAAC-1	Fibroblasts
TTCGTTAGTAAATTGC-1	Cardiomyocytes
TTGACATCAAGATTCT-1	Endothelial
TTGACATCATGTTGTG-1	Endothelial
TTGACATCATTGCAGC-1	Pericytes
TTGACTAAGCATGCAT-1	Cardiomyocytes
TTGACTAAGCCACATG-1	Pericytes
TTGACTAAGCCGCAAC-1	Pericytes
TTGACTAAGCGCATTG-1	Fibroblasts
TTGACTAAGGCGTAAA-1	Cardiomyocytes
TTGACTAAGGTGAAAT-1	Cardiomyocytes
TTGAGCTAGGCGAATA-1	Cardiomyocytes
TTGAGCTAGTAATCCA-1	Cardiomyocytes
TTGCAACAGGACCTGC-1	Neuronal
TTGCAAGGTACTGAAT-1	Cardiomyocytes
TTGCAAGGTTGTTGGA-1	Fibroblasts
TTGCAATCAACAGCCT-1	Fibroblasts
TTGCAATCACCTACGG-1	Fibroblasts
TTGCACACAGCAACCT-1	Fibroblasts
TTGCATTTCGTTTCCA-1	Fibroblasts
TTGCCCGTCCAGGTCA-1	Fibroblasts
TTGCCCGTCTAAGTCA-1	Endothelial
TTGCGAGTCAAACACC-1	Cardiomyocytes
TTGCGAGTCAAAGGCA-1	Cardiomyocytes
TTGCGAGTCGAGGAAC-1	Endothelial
TTGCGTCTCCTGGTCT-1	Endothelial
TTGCGTCTCCTTCTAG-1	Fibroblasts
TTGCGTCTCTATGACA-1	Cardiomyocytes
TTGCTCTCAAAGGTAC-1	Endothelial
TTGCTCTCAGCACCAT-1	Fibroblasts
TTGCTTAGTTGGTTCT-1	Cardiomyocytes
TTGCTTTAGCATGAAG-1	Fibroblasts
TTGCTTTAGCCGCTTT-1	Fibroblasts
TTGCTTTAGCCTTAAA-1	Adipocytes
TTGGAGGCAGGAAGCC-1	Endothelial
TTGGATATCAAAGGCA-1	Cardiomyocytes
TTGGATCAGCAAACCT-1	Smooth.muscle
TTGGATCAGGGTCTAT-1	Fibroblasts
TTGGATTCAAACTAAG-1	Cardiomyocytes
TTGGATTCAGGATTAA-1	Cardiomyocytes
TTGGCGGGTTGAGCCG-1	Endothelial
TTGGCTACAGTAAGTA-1	Endothelial
TTGGCTACATTAAACC-1	Cardiomyocytes
TTGGCTGAGACAGGTA-1	Cardiomyocytes
TTGGCTGAGTGGCGGA-1	Cardiomyocytes
TTGGGCCAGGTAAGGC-1	Cardiomyocytes
TTGGGTTAGCTGAGGG-1	Pericytes
TTGGGTTAGGACGTAA-1	Smooth.muscle
TTGGGTTAGGCGTAAA-1	Cardiomyocytes
TTGGGTTAGGGTGAAC-1	Cardiomyocytes
TTGGTGAGTGAATCGC-1	Cardiomyocytes
TTGTCAAAGGGTCCAC-1	Endothelial
TTGTCAAAGTTGTCAA-1	Cardiomyocytes
TTGTCCATCACTAATG-1	Cardiomyocytes
TTGTCCCAGAGAGGCT-1	Cardiomyocytes
TTGTCCCAGCGGATAA-1	Cardiomyocytes
TTGTCCGGTAAGCTTG-1	Endothelial
TTGTCCGGTTGTCCAT-1	Endothelial
TTGTGAGGTCCTCCAA-1	Cardiomyocytes
TTGTGAGGTTCGGTAA-1	Fibroblasts
TTGTGCCTCACATTGA-1	Endothelial
TTGTGCCTCCTGCGAA-1	Cardiomyocytes
TTGTGCGAGTAAGTGG-1	Fibroblasts
TTGTGCGAGTGAAGTG-1	Endothelial
TTGTGTGCACAAAGCG-1	Cardiomyocytes
TTGTGTGCACGAATCC-1	Endothelial
TTGTGTGCAGGTCCTG-1	Fibroblasts
TTGTTCCCACAAGCCT-1	Cardiomyocytes
TTGTTGCGTAGCCATA-1	Fibroblasts
TTGTTGCGTGATGAGG-1	Neuronal
TTGTTGCGTTGAGCCG-1	Fibroblasts
TTGTTGTTCGTTTCCA-1	Smooth.muscle
TTGTTTGGTGTTTGTC-1	Endothelial
TTTAACCTCACTAAGC-1	Endothelial
TTTAACGAGCTATTGA-1	Cardiomyocytes
TTTAAGGTCATCAGTA-1	Fibroblasts
TTTAAGGTCTAGCGAT-1	Cardiomyocytes
TTTACGAAGAGGAGTC-1	Cardiomyocytes
TTTACGAAGGTGTCCA-1	Endothelial
TTTAGCAAGGCGAAAC-1	Smooth.muscle
TTTAGCTTCGGTTCCT-1	Cardiomyocytes
TTTAGGATCAGCACGC-1	Fibroblasts
TTTAGGATCATAACGC-1	Endothelial
TTTAGGATCGCTAAGT-1	Pericytes
TTTAGGATCTGGCATG-1	Cardiomyocytes
TTTCACCCAGGTTCAC-1	Fibroblasts
TTTCAGTTCGAGGAGT-1	Cardiomyocytes
TTTCAGTTCTATCGCC-1	Cardiomyocytes
TTTCATCAGAACAAGT-1	Endothelial
TTTCATCAGCTCCTAC-1	Endothelial
TTTCATCAGGCTGTCA-1	Pericytes
TTTCCTGAGAAGCTAG-1	Cardiomyocytes
TTTCCTGAGGCGCATC-1	Cardiomyocytes
TTTCCTGAGGCTTAGT-1	Fibroblasts
TTTCTCACACAAAGCG-1	Endothelial
TTTCTCACACAGGAAT-1	Smooth.muscle
TTTCTCACACTAAGTT-1	Cardiomyocytes
TTTCTCACATAATCCG-1	Cardiomyocytes
TTTGACCGTGATGAAA-1	Pericytes
TTTGACCGTGCGCATG-1	Cardiomyocytes
TTTGACCGTGGTTAGC-1	Cardiomyocytes
TTTGACTTCAAACCTA-1	Fibroblasts
TTTGACTTCCTGGCTT-1	Endothelial
TTTGAGTCACCTCAGG-1	Cardiomyocytes
TTTGCATTCATGGTGT-1	Endothelial
TTTGCGACAAAGCTAA-1	Cardiomyocytes
TTTGCGACAATAAGCA-1	Cardiomyocytes
TTTGGCTGTACCTTAC-1	Pericytes
TTTGGCTGTACGTTTC-1	Cardiomyocytes
TTTGGCTGTGAGACTC-1	Cardiomyocytes
TTTGGCTGTGCTTAGA-1	Endothelial
TTTGGCTGTGTTTGTC-1	Pericytes
TTTGGCTGTTTATGGG-1	Cardiomyocytes
TTTGGTGCATAATCAC-1	Fibroblasts
TTTGGTGCATTGGGAG-1	Cardiomyocytes
TTTGTCCCATGAAGTA-1	Cardiomyocytes
TTTGTCCCATGTTGCA-1	Fibroblasts
TTTGTGAAGCATGTTA-1	Cardiomyocytes
TTTGTGTTCCAATAGC-1	Fibroblasts
TTTGTGTTCCATAAGC-1	Cardiomyocytes
TTTGTGTTCTTTGAGA-1	Fibroblasts
