Index	Cell_type
AAACCAACAATTTAGC-1	Endothelial_cell
AAACCAACACAATTAC-1	Cardiomyocyte
AAAGCCGCAACCTGGT-1	Fibroblast
AAATCCGGTAGGATTT-1	Adrenal_gland_inflammatory_cell
AAATCCGGTTGTCATC-1	Fibroblast
AAATGCCTCCTAAGGT-1	Adrenal_gland_inflammatory_cell
AACAAGCCACCTAAGC-1	Smooth_muscle_cell
AACAGGATCCGGCTAA-1	Adrenal_gland_inflammatory_cell
AACCCGCAGGCTCATG-1	Fibroblast
AACCTCACAATAGCCC-1	Fibroblast
AACCTCCTCACAAGCT-1	Cardiomyocyte
AACGCCCAGCACTAAC-1	Fibroblast
AACGCTAGTTCAAGCA-1	Cardiomyocyte
AACGCTAGTTTGGTTC-1	Endothelial_cell
AACTAGTGTGGGTACT-1	Cardiomyocyte
AACTGTTCACCTATAG-1	Cardiomyocyte
AACTTAGTCGTTACTT-1	Cardiomyocyte
AAGACAAGTCCTAACT-1	Endothelial_cell
AAGACCAAGCAAGATG-1	Fibroblast
AAGACCAAGGAAGCAC-1	Fibroblast
AAGCATGAGACAGGCG-1	Endothelial_cell
AAGCATGAGCATGAAG-1	Fibroblast
AAGCATGAGGCTACAT-1	Endothelial_cell
AAGCCACGTTTACGTC-1	Cardiomyocyte
AAGCCTCCATTATGGT-1	Endothelial_cell
AAGCGAATCATTATGG-1	Cardiomyocyte
AAGCGTTTCGACAAAG-1	Fibroblast
AAGCTAGAGGACCTCA-1	Cardiomyocyte
AAGCTAGAGGCCTTAG-1	Fibroblast
AAGCTTGGTCACAGCG-1	Pericyte
AAGGATGTCCTCACTA-1	Smooth_muscle_cell
AAGGATGTCGTTATAG-1	Fibroblast
AAGGCCCTCAGTATTG-1	Cardiomyocyte
AAGGTATAGGATTGCT-1	Immune_cell
AAGGTATAGGCGGATG-1	Cardiomyocyte
AAGGTGCAGTTCCCGT-1	Fibroblast
AAGTGAAGTCTTTGAC-1	Fibroblast
AAGTGCAAGAGAGGCT-1	Fibroblast
AAGTGCAAGCGATACT-1	Endothelial_cell
AAGTTACGTGAGCAAG-1	Endothelial_cell
AAGTTACGTTTATCGC-1	Immune_cell
AATACCGGTAGGATCC-1	Pericyte
AATACCGGTTGTAACG-1	Pericyte
AATATCCCAACTAGGG-1	Endothelial_cell
AATCATCCAGCACGAA-1	Endothelial_cell
AATCATCCATCGCTCC-1	Fibroblast
AATCATCCATCGCTTT-1	Cardiomyocyte
AATCATGTCAGTGAAG-1	Fibroblast
AATCATGTCATGTTTC-1	Endothelial_cell
AATCATGTCTGGCTTC-1	Fibroblast
AATCCCTGTGTTTGCT-1	Fibroblast
AATCCTAAGGCCCAGT-1	Endothelial_cell
AATCGCCCATTGCGAC-1	Fibroblast
AATCTCAAGTTCCCGT-1	Fibroblast
AATGGCGCAATCTCTC-1	Cardiomyocyte
AATGGCGCACCGGCTA-1	Cardiomyocyte
AATGTCCAGACTATTG-1	Pericyte
AATGTCCAGCAAGGTA-1	Pericyte
AATGTCCAGGAGGACT-1	Endothelial_cell
AATTACCCAACTAGAA-1	Cardiomyocyte
AATTACCCATGTTTGG-1	Cardiomyocyte
AATTGACGTAATGACT-1	Immune_cell
AATTGACGTATTGAGT-1	Cardiomyocyte
AATTGACGTTAGCTGA-1	Fibroblast
AATTGGACACATTGCA-1	Fibroblast
AATTGGACATATAACC-1	Fibroblast
AATTGTGTCAGCATTA-1	Fibroblast
AATTTGGTCCTCACTA-1	Pericyte
ACAACACTCAAAGGCA-1	Endothelial_cell
ACAACAGAGCATGCAT-1	Fibroblast
ACAACAGAGCTCAAAC-1	Fibroblast
ACACAATGTGTTCCCA-1	Fibroblast
ACACCTTGTCACACCC-1	Fibroblast
ACACTAATCGATTTGA-1	Cardiomyocyte
ACAGCGCTCGCTATAA-1	Fibroblast
ACAGGATCATACTCCT-1	Fibroblast
ACATTAGTCCTTAGTT-1	Cardiomyocyte
ACATTGCAGTTATGGC-1	Fibroblast
ACCAAACTCTTGCAAA-1	Immune_cell
ACCACACCAAGCTTAT-1	Endothelial_cell
ACCACACCACTAGCGT-1	Fibroblast
ACCACACCAGGCGATA-1	Endothelial_cell
ACCACATAGGTACCGC-1	Fibroblast
ACCAGCTCACTGACTA-1	Endothelial_cell
ACCAGGCTCGCCTAAG-1	Cardiomyocyte
ACCAGGGAGTAGCGGG-1	Fibroblast
ACCATAATCAGCACCA-1	Cardiomyocyte
ACCATTAAGCCGCAAC-1	Cardiomyocyte
ACCCAACCATGAGTTT-1	Pericyte
ACCCTGTTCCGCAACA-1	Cardiomyocyte
ACCGAAGCACCGTTCC-1	Fibroblast
ACCGAAGCATCTTGAG-1	Fibroblast
ACCGGTTCAGTCTAAT-1	Cardiomyocyte
ACCTCACTCTTGCATT-1	Immune_cell
ACCTGGTCAATTAGGA-1	Smooth_muscle_cell
ACCTGGTCACTTAACG-1	Cardiomyocyte
ACCTTCCAGTTGGCCA-1	Fibroblast
ACCTTGTGTATTGTCC-1	Endothelial_cell
ACGAAGTCACCTCACC-1	Endothelial_cell
ACGAATCTCCCTCATA-1	Endothelial_cell
ACGAGTAAGCACAGAA-1	Cardiomyocyte
ACGAGTAAGCTGTAAC-1	Endothelial_cell
ACGCCACAGCAGCTAT-1	Pericyte
ACGCCACAGCCTAACG-1	Cardiomyocyte
ACGCCACAGTTTGTCT-1	Fibroblast
ACGCCTAAGCTTAGTA-1	Endothelial_cell
ACGCCTAAGGTTTGAC-1	Fibroblast
ACGCCTTTCCTGATTT-1	Smooth_muscle_cell
ACGCTTGAGGCCTAAT-1	Fibroblast
ACGGGAAGTTCCTCCT-1	Cardiomyocyte
ACGGTTAGTCATAAGT-1	Pericyte
ACGTACCCAGGTTATT-1	Cardiomyocyte
ACGTCAAGTAGCAGCT-1	Cardiomyocyte
ACGTCCAAGAGGGACT-1	Cardiomyocyte
ACGTTACAGTTACCGG-1	Endothelial_cell
ACTAACCAGGCCAATT-1	Fibroblast
ACTAGGCGTGGACCTG-1	Cardiomyocyte
ACTAGGCGTGGTTCTT-1	Pericyte
ACTCACCTCCGGTTAG-1	Smooth_muscle_cell
ACTCCTCAGTAGGCGG-1	Fibroblast
ACTCGCGCAGTTATCG-1	Cardiomyocyte
ACTCGCTTCGCAGGCT-1	Pericyte
ACTTAGGGTTAGGCTA-1	Fibroblast
ACTTGAATCAAGACTC-1	Cardiomyocyte
ACTTGTAAGAGGATAT-1	Cardiomyocyte
ACTTGTAAGGCCCAGT-1	Cardiomyocyte
ACTTGTCGTTGTGACA-1	Cardiomyocyte
AGAAACCCAATTTGGT-1	Cardiomyocyte
AGAAACCCATGAATAG-1	Fibroblast
AGAAACTAGAGAGGAG-1	Endothelial_cell
AGAAAGGCAGTAGCCT-1	Cardiomyocyte
AGAACAAGTGGATGTC-1	Endothelial_cell
AGAACCAAGTTAGTTG-1	Cardiomyocyte
AGAACCGCAACACCTA-1	Fibroblast
AGAACCGCAATTAACC-1	Pericyte
AGAAGGTGTGGAGCAA-1	Fibroblast
AGAAGGTGTTAGCGTA-1	Pericyte
AGAATCTGTTAGCATG-1	Fibroblast
AGACAATAGTTGCGTG-1	Fibroblast
AGAGAAGCAAGGTAAC-1	Fibroblast
AGAGATTAGTATTGCA-1	Fibroblast
AGAGGATGTGCTCCAC-1	Immune_cell
AGAGGATGTTGCTTCG-1	Fibroblast
AGATGAAGTTTATTCG-1	Endothelial_cell
AGCAAATAGGACCGCT-1	Fibroblast
AGCACTAGTAGCCATA-1	Cardiomyocyte
AGCACTTAGACAGGTA-1	Endothelial_cell
AGCAGGTAGCAAGGTA-1	Fibroblast
AGCATCCCAACACTTG-1	Endothelial_cell
AGCATCCCATAACGGG-1	Endothelial_cell
AGCATTTCAGGACCAA-1	Cardiomyocyte
AGCCGCTAGTTATTCC-1	Fibroblast
AGCCTAAGTAGGATTT-1	Endothelial_cell
AGCCTAGTCCGCAACA-1	Cardiomyocyte
AGCCTAGTCCTCCCTC-1	Pericyte
AGCCTCCGTTGAAGCC-1	Fibroblast
AGCGCCTAGCTTAACA-1	Cardiomyocyte
AGCGCTCAGTTATGTG-1	Cardiomyocyte
AGCGGATAGGACAATG-1	Fibroblast
AGCTAACTCCTGGCTT-1	Cardiomyocyte
AGCTAACTCCTTTACG-1	Cardiomyocyte
AGCTAACTCGTTACTT-1	Immune_cell
AGCTACTAGTTTCCGC-1	Immune_cell
AGCTTAATCTTGACCC-1	Endothelial_cell
AGGAAACGTGGATTAT-1	Cardiomyocyte
AGGACGTAGCACCACA-1	Pericyte
AGGAGCTAGTAACTCA-1	Fibroblast
AGGATATAGAGGAAGG-1	Adrenal_gland_inflammatory_cell
AGGCAATCATCCCTCA-1	Fibroblast
AGGCCCAGTTCCGCAC-1	Fibroblast
AGGCTAAAGCTGCACA-1	Fibroblast
AGGGCCTTCTTTAAGG-1	Pericyte
AGGTGAATCTTGAGCG-1	Fibroblast
AGGTTAACAAGGAATC-1	Fibroblast
AGGTTTATCGGTCAGC-1	Endothelial_cell
AGGTTTGGTCAACAAT-1	Fibroblast
AGGTTTGGTCTTTGAC-1	Fibroblast
AGGTTTGGTGCGCAAT-1	Adrenal_gland_inflammatory_cell
AGTAATGCACCTACTT-1	Endothelial_cell
AGTAATGCAGGCATCT-1	Endothelial_cell
AGTATAGCAATAAGCA-1	Endothelial_cell
AGTCAATGTCTATCGT-1	Fibroblast
AGTCGCATCCTTAAGA-1	Fibroblast
AGTGCACGTAGCTAGC-1	Fibroblast
AGTGCGGAGTGCACGC-1	Fibroblast
AGTGTTTCAGGCGAGT-1	Fibroblast
AGTTACATCTAGCTAA-1	Fibroblast
AGTTACTCATGCTATG-1	Fibroblast
AGTTGCAGTAATGGAA-1	Fibroblast
AGTTGTCAGTTTAACG-1	Fibroblast
AGTTTGATCATGAGCT-1	Endothelial_cell
ATAATGGCAGGTTATT-1	Pericyte
ATACCGGTCTGGCAAT-1	Immune_cell
ATCAAGACAACTAGAA-1	Pericyte
ATCAAGCTCCTCGATC-1	Immune_cell
ATCAAGCTCGATTTAG-1	Cardiomyocyte
ATCAATCCAGGAAGCC-1	Fibroblast
ATCACAATCAGCAAGA-1	Endothelial_cell
ATCACTAAGCCTGACA-1	Fibroblast
ATCACTAAGTACCGCA-1	Cardiomyocyte
ATCATCAAGTCCTGAG-1	Endothelial_cell
ATCATGTCAATTAAGG-1	Smooth_muscle_cell
ATCCATAAGGCTGTGC-1	Endothelial_cell
ATCCCGCGTAACCAGC-1	Cardiomyocyte
ATCCGTGAGGGTTATC-1	Fibroblast
ATCGAGGCACAAAGGT-1	Fibroblast
ATCGGCCAGCCGCAGT-1	Fibroblast
ATCGGCCAGCTCCCTG-1	Cardiomyocyte
ATCGGCCAGGAGTCGG-1	Fibroblast
ATCGGCCAGGTAACGA-1	Endothelial_cell
ATCTATGAGCTGTACG-1	Fibroblast
ATGAAGCCAACACTTG-1	Adrenal_gland_inflammatory_cell
ATGAAGCCATCCAGGT-1	Endothelial_cell
ATGAAGTAGCAGCTCA-1	Endothelial_cell
ATGACGAAGGTTAGAG-1	Fibroblast
ATGCAAACAAATATCC-1	Fibroblast
ATGCAGGCATCACAGC-1	Fibroblast
ATGCGATTCAACAAGG-1	Endothelial_cell
ATGGCCCAGTCGCTAG-1	Endothelial_cell
ATGGCTGTCCGGTTAG-1	Smooth_muscle_cell
ATGGCTTAGCGTGCGT-1	Cardiomyocyte
ATGGTCTAGGAACGGT-1	Fibroblast
ATGGTTATCAAGCGCC-1	Cardiomyocyte
ATGTGAGAGCGCCTAA-1	Pericyte
ATGTGAGAGGTCCAAT-1	Cardiomyocyte
ATGTGAGAGTCATGCG-1	Cardiomyocyte
ATTAACCCACAGGATG-1	Endothelial_cell
ATTACTGAGAGCCGCT-1	Immune_cell
ATTAGCTCACATTGCA-1	Fibroblast
ATTAGGTGTGAGACTC-1	Adrenal_gland_inflammatory_cell
ATTAGGTGTGGAGCAA-1	Cardiomyocyte
ATTAGGTGTTAGACCA-1	Fibroblast
ATTAGGTGTTCAAGAT-1	Fibroblast
ATTAGTCCATTGACAT-1	Cardiomyocyte
ATTATGGTCTCTAGCC-1	Cardiomyocyte
ATTCCGGAGTATTGGC-1	Fibroblast
ATTGCAGGTTAAGGCC-1	Cardiomyocyte
ATTGCGCCACCACAAC-1	Pericyte
ATTGCTCGTAGGATTT-1	Endothelial_cell
ATTGTCCGTTACCGGG-1	Cardiomyocyte
ATTTGCAAGCAGGTGG-1	Endothelial_cell
ATTTGCAAGGGTGAGT-1	Immune_cell
ATTTGCAAGTGACCTG-1	Cardiomyocyte
ATTTGCGCATGACTAT-1	Endothelial_cell
CAAACCGTCATGACCG-1	Cardiomyocyte
CAACCCGCATAAGGAC-1	Fibroblast
CAACTAATCAGCAAAG-1	Cardiomyocyte
CAAGGCCTCATGCTCC-1	Endothelial_cell
CAAGGCTGTATGGTGC-1	Fibroblast
CAAGGCTGTGTGAGGA-1	Endothelial_cell
CAAGGGAGTGTTCCCA-1	Fibroblast
CAAGGTTTCGTTAACA-1	Cardiomyocyte
CAAGTATGTGACCTGG-1	Fibroblast
CAAGTATGTGTGCAAC-1	Smooth_muscle_cell
CAAGTGAAGTAACCCG-1	Endothelial_cell
CAAGTGAAGTCAATTG-1	Endothelial_cell
CAAGTTATCATAACTG-1	Adrenal_gland_inflammatory_cell
CAATAAGCAAGCTAAA-1	Cardiomyocyte
CAATCCCTCCAAGTGT-1	Endothelial_cell
CAATCCTGTAATCGCA-1	Immune_cell
CAATCGCCAAACATAG-1	Pericyte
CAATCTAAGGTACCGC-1	Pericyte
CAATGACTCTTGCATT-1	Pericyte
CACAGGGAGAGAAGGG-1	Fibroblast
CACCAACCACTGGCTG-1	Endothelial_cell
CACCTCAGTAGGATCC-1	Endothelial_cell
CACCTGTTCGAGGTGG-1	Cardiomyocyte
CACGCAATCGGTTTGG-1	Cardiomyocyte
CACGCTAAGGCAAGTA-1	Endothelial_cell
CACTTTGTCCTCAGCT-1	Endothelial_cell
CAGAACCGTGAGGTAG-1	Pericyte
CAGCATGTCAATGTCA-1	Fibroblast
CAGCATTAGCCGCTAA-1	Cardiomyocyte
CAGCTATAGGAAGCAC-1	Fibroblast
CAGCTCAAGGACAATG-1	Cardiomyocyte
CAGGAAGGTGGAAGGC-1	Fibroblast
CAGGACACACAGAAAC-1	Endothelial_cell
CAGGACCTCGCTAAGT-1	Cardiomyocyte
CAGGCTATCAGGAAGC-1	Cardiomyocyte
CAGGTCCAGGTGAAGC-1	Endothelial_cell
CAGGTGGAGTACCGCA-1	Pericyte
CAGGTTAGTACTTAGG-1	Fibroblast
CAGGTTAGTTGTAAAC-1	Cardiomyocyte
CAGGTTTAGGGCTAAA-1	Endothelial_cell
CAGTATGGTAATCCCT-1	Fibroblast
CAGTATGGTATGTGGC-1	Adrenal_gland_inflammatory_cell
CAGTATGGTGTTGTAG-1	Smooth_muscle_cell
CATAATCCATAATGAG-1	Fibroblast
CATAATGTCAAACCTA-1	Fibroblast
CATAATGTCACTCAAA-1	Fibroblast
CATAATGTCATGACCG-1	Fibroblast
CATAGACTCCTGCGAA-1	Immune_cell
CATAGCTAGGGATTAG-1	Endothelial_cell
CATAGGTTCAATGACC-1	Fibroblast
CATAGGTTCCGGTTAG-1	Fibroblast
CATCAGCCATAAAGCA-1	Endothelial_cell
CATCGCTTCCACCTGT-1	Cardiomyocyte
CATCGCTTCCCATAAA-1	Fibroblast
CATGCGCAGATGCCTG-1	Cardiomyocyte
CATGCGCAGATTGAGG-1	Fibroblast
CATGGATTCCAGGGAG-1	Cardiomyocyte
CATTATGAGTGAGCAA-1	Fibroblast
CATTCATTCTCAATGA-1	Endothelial_cell
CATTGCGAGGAGGACT-1	Endothelial_cell
CCAAACTAGCTATATG-1	Fibroblast
CCAAACTAGTCATCCC-1	Cardiomyocyte
CCAACATAGGGCCATC-1	Endothelial_cell
CCACACAAGGCATTGT-1	Fibroblast
CCACATTGTAGCTAAT-1	Immune_cell
CCACATTGTGCTAGCG-1	Immune_cell
CCACATTGTTCAAGCA-1	Fibroblast
CCACTTGGTACGTTTC-1	Pericyte
CCACTTGGTTCACTGT-1	Endothelial_cell
CCAGCTAAGCCGCAGT-1	Cardiomyocyte
CCAGGATGTTCCGCAC-1	Cardiomyocyte
CCAGGATGTTGACTTC-1	Fibroblast
CCATAATCAATAGCCC-1	Cardiomyocyte
CCATAGCCAGCTCAAC-1	Cardiomyocyte
CCATTATTCCGCCAAA-1	Smooth_muscle_cell
CCCAAACCAGGCGATA-1	Endothelial_cell
CCCAACCGTGCACGCA-1	Smooth_muscle_cell
CCCAACCGTTTCCGGC-1	Cardiomyocyte
CCCATAACACCAGGTT-1	Fibroblast
CCCGTTGTCATTGCGG-1	Cardiomyocyte
CCCGTTGTCGCTTCTA-1	Cardiomyocyte
CCCTCAGTCCGGAACC-1	Smooth_muscle_cell
CCCTCAGTCTTAGCCC-1	Cardiomyocyte
CCCTGTTAGTCATGCG-1	Endothelial_cell
CCGCTAAAGCTCCCTG-1	Cardiomyocyte
CCGCTAGCATGGCCCA-1	Fibroblast
CCGGTTAAGGAACGGT-1	Fibroblast
CCGGTTAAGGCTTAGT-1	Smooth_muscle_cell
CCGTGCTGTCATAAGT-1	Pericyte
CCGTTAACACGTAATT-1	Fibroblast
CCGTTGCGTACCGTAA-1	Cardiomyocyte
CCGTTTGGTCGACTAA-1	Fibroblast
CCTAAAGGTCACAGAC-1	Pericyte
CCTAAGTAGGAACACA-1	Fibroblast
CCTACTGGTGATTTGG-1	Immune_cell
CCTAGTTGTCCGGTTC-1	Cardiomyocyte
CCTATTGTCAAAGGCA-1	Fibroblast
CCTATTGTCATGAGCT-1	Endothelial_cell
CCTCAAACACCAGGTT-1	Pericyte
CCTCAAACATGAATAG-1	Immune_cell
CCTCAGTTCATTATGG-1	Cardiomyocyte
CCTCCTCTCGATTATG-1	Fibroblast
CCTCCTGAGTAACGGA-1	Pericyte
CCTGAATAGTAACTCA-1	Fibroblast
CCTGAGTCAAAGGCCA-1	Cardiomyocyte
CCTGATGAGTTGGCCA-1	Cardiomyocyte
CCTGGTAAGATAACCC-1	Fibroblast
CCTGGTAAGTTCCTGC-1	Endothelial_cell
CCTGTTGGTGAGAAAC-1	Pericyte
CCTGTTGGTTTGCGCC-1	Fibroblast
CCTTACTCAAAGGTAC-1	Immune_cell
CCTTAGTGTGAACAAA-1	Fibroblast
CCTTCGGTCAGGAAGC-1	Cardiomyocyte
CCTTCGGTCTGTAAGC-1	Cardiomyocyte
CCTTCGTAGACACTTA-1	Pericyte
CCTTCGTAGAGAGCCG-1	Endothelial_cell
CCTTGCGTCTTGTTCG-1	Fibroblast
CCTTGTTCACCTGCTC-1	Adrenal_gland_inflammatory_cell
CGAACAAAGTACTGGT-1	Cardiomyocyte
CGAACCGGTGCGCATG-1	Cardiomyocyte
CGAATATGTGTTTGCT-1	Fibroblast
CGAATATGTTAGCGTA-1	Adrenal_gland_inflammatory_cell
CGACCTGCAAACCCTA-1	Fibroblast
CGACTAAGTTCCAGGG-1	Cardiomyocyte
CGAGCTGGTTCAAGCA-1	Cardiomyocyte
CGAGTCGGTCAAAGGG-1	Endothelial_cell
CGATTCCTCAATAGCC-1	Cardiomyocyte
CGATTCCTCATTAGTG-1	Fibroblast
CGATTCCTCTTGATGA-1	Pericyte
CGATTGAGTTACTTCA-1	Endothelial_cell
CGCAATAGTCTCACTG-1	Endothelial_cell
CGCAATCCAGAAACGT-1	Fibroblast
CGCACAATCTGGTCCT-1	Fibroblast
CGCATTTGTGCTCCGT-1	Fibroblast
CGCTAACCAAGTCGCT-1	Cardiomyocyte
CGCTAACCAGATTCAT-1	Cardiomyocyte
CGCTACTTCTGGCATG-1	Fibroblast
CGCTCAGCAAAGCGGC-1	Endothelial_cell
CGCTCAGCAAGCCACT-1	Fibroblast
CGCTTAACATCACAGC-1	Cardiomyocyte
CGCTTCTAGCCGCAAC-1	Endothelial_cell
CGCTTGCGTCAAGTAT-1	Fibroblast
CGCTTGCGTTGGCCGA-1	Endothelial_cell
CGGACAACAACTAACT-1	Cardiomyocyte
CGGACCTAGGCTAATC-1	Fibroblast
CGGACCTAGTTATGTG-1	Cardiomyocyte
CGGATTAGTGAGCACT-1	Cardiomyocyte
CGGCCATAGGTTAGCT-1	Endothelial_cell
CGGCTAATCCTTAGGG-1	Cardiomyocyte
CGGGCTTAGTAAGAAC-1	Pericyte
CGGGCTTAGTTCCCAC-1	Cardiomyocyte
CGGGTATGTCACCAAA-1	Endothelial_cell
CGGGTCTAGGGTCCAC-1	Cardiomyocyte
CGGTTATAGGATCACT-1	Cardiomyocyte
CGGTTCCGTTTAAAGC-1	Cardiomyocyte
CGGTTTGAGCGAAGTA-1	Pericyte
CGTAACCCACCTATAG-1	Smooth_muscle_cell
CGTAACTAGAATCGCT-1	Endothelial_cell
CGTAACTAGTCGCTAG-1	Fibroblast
CGTACGGGTTGCTTCG-1	Endothelial_cell
CGTAGCGGTTTCCGGC-1	Endothelial_cell
CGTGACATCAAGCGCC-1	Fibroblast
CGTGCTTTCCAATTAG-1	Cardiomyocyte
CGTGCTTTCGTTAGCG-1	Pericyte
CGTGGTTCATAGGCGA-1	Cardiomyocyte
CGTGTGTCATGATTGT-1	Cardiomyocyte
CGTGTTACACGTAATT-1	Cardiomyocyte
CGTTAACAGGCTTAGT-1	Cardiomyocyte
CGTTTCTCAGGCTAAG-1	Cardiomyocyte
CTAAAGCTCACACAGT-1	Fibroblast
CTAAAGCTCCTCGATC-1	Endothelial_cell
CTAAAGCTCGCTTCTA-1	Fibroblast
CTAAATGTCCTTGTTG-1	Pericyte
CTAAGTCAGGATCCGC-1	Endothelial_cell
CTAATCCGTCATAGAT-1	Immune_cell
CTAATGTCATTGTGCA-1	Cardiomyocyte
CTACAACAGAGGATAT-1	Endothelial_cell
CTACAACAGTTGGATC-1	Fibroblast
CTACGAAGTCAGGAAG-1	Adrenal_gland_inflammatory_cell
CTACGAAGTTATGTGG-1	Immune_cell
CTACTTAGTAAGCACC-1	Cardiomyocyte
CTAGATTCACAACCTA-1	Cardiomyocyte
CTAGATTCACGTTACA-1	Cardiomyocyte
CTAGCGGGTACCGTTT-1	Cardiomyocyte
CTAGCGGGTGAGCGAA-1	Cardiomyocyte
CTAGCTGAGCAAGATG-1	Fibroblast
CTAGCTTGTCCTAAGA-1	Cardiomyocyte
CTAGGCGGTTACTTCA-1	Cardiomyocyte
CTAGGCGGTTGTCCAT-1	Endothelial_cell
CTAGTAGGTGCGCATG-1	Cardiomyocyte
CTATGAGGTTAAGGTT-1	Fibroblast
CTATGAGGTTGCTGGG-1	Cardiomyocyte
CTATGGCCAGGACCAA-1	Cardiomyocyte
CTATGTTTCCATAATG-1	Cardiomyocyte
CTCAATAAGGTTAGCT-1	Adrenal_gland_inflammatory_cell
CTCACAACAATTAGCT-1	Endothelial_cell
CTCAGGATCCCAGTAG-1	Fibroblast
CTCAGGATCTGTAATG-1	Endothelial_cell
CTCCAACTCCACCTGT-1	Endothelial_cell
CTCCATCAGGTCCAAT-1	Cardiomyocyte
CTCCCTGAGCCTAATA-1	Cardiomyocyte
CTCCCTGAGGCTACAT-1	Fibroblast
CTCCGGACACCAGCAT-1	Cardiomyocyte
CTCCGGACAGCCTGCA-1	Fibroblast
CTCCTAATCACAGCGC-1	Fibroblast
CTCCTAATCGCTAGCA-1	Adrenal_gland_inflammatory_cell
CTCCTAATCTGGTCCT-1	Cardiomyocyte
CTCGACAAGCCACAAT-1	Pericyte
CTCGCTCCACCTCAGG-1	Fibroblast
CTCGCTCCATAACGGG-1	Pericyte
CTCTAGCTCGATTTAG-1	Immune_cell
CTGAAACTCGTTAGCG-1	Fibroblast
CTGACATAGCTAATCA-1	Endothelial_cell
CTGACCAAGGATAAAC-1	Cardiomyocyte
CTGATCACAAGCGAGC-1	Cardiomyocyte
CTGATCACATCTAGCA-1	Endothelial_cell
CTGCAATAGGAAGTAT-1	Cardiomyocyte
CTGCTACTCACAGGAA-1	Cardiomyocyte
CTGCTACTCAGCATTA-1	Fibroblast
CTGCTACTCCAGGTCA-1	Immune_cell
CTGGATGTCATAGCCG-1	Fibroblast
CTGGCTAAGCAGCTAT-1	Pericyte
CTGGTAAGTTACCGGG-1	Endothelial_cell
CTGGTCAAGCGAGGTG-1	Pericyte
CTGGTTACACACCAAC-1	Fibroblast
CTGTAACAGCTTCTCA-1	Cardiomyocyte
CTGTACCTCGTTACTT-1	Endothelial_cell
CTGTACCTCTTAGTGA-1	Cardiomyocyte
CTGTTAAAGTGAGGTA-1	Fibroblast
CTGTTCATCATGGCCA-1	Fibroblast
CTGTTCATCCGCATGA-1	Fibroblast
CTGTTGGAGTATTGGC-1	Endothelial_cell
CTTAAGATCGAGCTAT-1	Cardiomyocyte
CTTAAGGGTCCTAATC-1	Adrenal_gland_inflammatory_cell
CTTAATGAGCATGCAT-1	Fibroblast
CTTAATGAGCTAATCA-1	Adrenal_gland_inflammatory_cell
CTTAATGAGTCTCACC-1	Fibroblast
CTTACTAGTCAATAGT-1	Immune_cell
CTTAGGAGTGTGCAAC-1	Cardiomyocyte
CTTATTGGTGGAAACG-1	Pericyte
CTTCGCGTCAATGAGG-1	Cardiomyocyte
CTTCGCGTCGCTTCTA-1	Cardiomyocyte
CTTGAATCAGCAAATA-1	Pericyte
CTTGAATCAGTAGGAT-1	Fibroblast
CTTGACGAGTCAGTAC-1	Cardiomyocyte
CTTGCAACACGTTACA-1	Fibroblast
CTTGGACCAATTTGGT-1	Fibroblast
CTTTAGTTCGTTTCGC-1	Cardiomyocyte
CTTTATGGTTAGAGCC-1	Cardiomyocyte
CTTTATGGTTCAAGCA-1	Endothelial_cell
CTTTGAGCAGAAATTG-1	Adrenal_gland_inflammatory_cell
GAAAGCCAGGTTTACA-1	Endothelial_cell
GAAAGGCTCCAATAGC-1	Cardiomyocyte
GAACACAAGCACTTGG-1	Endothelial_cell
GAACACAAGCAGCTAT-1	Endothelial_cell
GAACACAAGCTGGCTA-1	Fibroblast
GAACCAAAGTCCTTTG-1	Cardiomyocyte
GAAGCCTGTACTGATG-1	Pericyte
GAAGCTAAGCACTAAC-1	Fibroblast
GAAGCTAAGCGTGCAC-1	Fibroblast
GAAGGAACAGTTAAAG-1	Pericyte
GAAGGCCCATCCCGCT-1	Fibroblast
GAAGTCAAGCTTAACA-1	Endothelial_cell
GAATTTGTCATGCCTC-1	Fibroblast
GACAATACACTATGGC-1	Cardiomyocyte
GACACCGGTAGCTGCG-1	Endothelial_cell
GACCGTTCAGTTAGCC-1	Adrenal_gland_inflammatory_cell
GACCTAAGTTTGTCTA-1	Fibroblast
GACCTCAAGTTGTCCC-1	Cardiomyocyte
GACCTGATCGTTTCCA-1	Endothelial_cell
GACCTGATCTCAATTC-1	Endothelial_cell
GACCTGCAGCTATTAG-1	Fibroblast
GACTCACCAACCTAAT-1	Cardiomyocyte
GAGAGGCGTTTAACCC-1	Cardiomyocyte
GAGATAAGTTTGTTGC-1	Fibroblast
GAGCAAATCCACCTTA-1	Cardiomyocyte
GAGCAAATCTCACATT-1	Endothelial_cell
GAGCAAGGTTATCCGT-1	Endothelial_cell
GAGCCACTCATGAGCT-1	Adrenal_gland_inflammatory_cell
GAGCCTTCAGGTTAAA-1	Cardiomyocyte
GAGCGAAGTGTGAGAG-1	Endothelial_cell
GAGCGATAGTATTGGC-1	Fibroblast
GAGCGATAGTTAGGCT-1	Endothelial_cell
GAGCGGTCAAAGGCCA-1	Smooth_muscle_cell
GAGCTGCTCCAAACAC-1	Adrenal_gland_inflammatory_cell
GAGCTGCTCGCATTAA-1	Cardiomyocyte
GAGCTTAGTCACAGAC-1	Immune_cell
GAGGACTAGCTATTAG-1	Fibroblast
GAGGAGGCAGGCTAGA-1	Cardiomyocyte
GAGGCTACACGGTTTA-1	Fibroblast
GAGGTACAGGACACTT-1	Immune_cell
GAGGTTAAGAGGATAT-1	Endothelial_cell
GAGTAATAGGGTGAAC-1	Immune_cell
GAGTATCTCCAAACAC-1	Immune_cell
GAGTATCTCCGCATGA-1	Fibroblast
GAGTATCTCGATATTG-1	Endothelial_cell
GAGTGTTTCTAGCTAA-1	Endothelial_cell
GAGTGTTTCTTGACCC-1	Endothelial_cell
GAGTTACTCCCTCGCA-1	Immune_cell
GAGTTTGGTTAGGTGC-1	Fibroblast
GATAAAGGTAACCACA-1	Fibroblast
GATAAAGGTCTATCGT-1	Fibroblast
GATAAAGGTTCCGGGA-1	Cardiomyocyte
GATCACTAGACAACAG-1	Endothelial_cell
GATCACTAGCCTGAGC-1	Cardiomyocyte
GATCAGTTCAAACACC-1	Endothelial_cell
GATCCGTCATCGCTCC-1	Cardiomyocyte
GATCGAGCAGTATGTT-1	Smooth_muscle_cell
GATCGATTCGCTTGCT-1	Fibroblast
GATGACTTCCTTAGGG-1	Fibroblast
GATGAGGGTTACCGGG-1	Fibroblast
GATGGACAGTTTGGTA-1	Endothelial_cell
GATTAAGCAACTCGCG-1	Cardiomyocyte
GATTAGTGTTTGTGGA-1	Fibroblast
GATTATGTCAAGCCTG-1	Fibroblast
GATTATGTCTTGCTAT-1	Pericyte
GATTCATCAATTGAAG-1	Fibroblast
GATTCATCAGGTTATT-1	Fibroblast
GATTCCTGTGAAGCCT-1	Smooth_muscle_cell
GATTGCAGTGTTTGAG-1	Cardiomyocyte
GATTGTTCACAATGCC-1	Cardiomyocyte
GCAATAGAGCAACATC-1	Fibroblast
GCAATAGAGCTCAAAC-1	Fibroblast
GCAATATGTCAAACTG-1	Cardiomyocyte
GCAATCTAGAGGAAGG-1	Fibroblast
GCAATCTAGTCATCCC-1	Cardiomyocyte
GCAATGTTCATGGTTA-1	Fibroblast
GCACATTAGCCGCTTT-1	Endothelial_cell
GCACCTAAGCCACATG-1	Endothelial_cell
GCACGAACAATCGCAC-1	Fibroblast
GCACGCTAGCGCATTG-1	Fibroblast
GCACGCTAGTGTTGCG-1	Cardiomyocyte
GCAGCAACAGGATGGC-1	Fibroblast
GCAGCCAGTCAGTAAT-1	Fibroblast
GCAGGACCACTAGGTC-1	Pericyte
GCAGGATAGAGGAGGA-1	Adrenal_gland_inflammatory_cell
GCAGGCTTCCGTTATT-1	Fibroblast
GCAGGCTTCCTGATGG-1	Fibroblast
GCAGGCTTCGAGGTGG-1	Endothelial_cell
GCATGAAAGTTGGCCA-1	Endothelial_cell
GCATTAGGTTTAGCGA-1	Fibroblast
GCCAATAGTACCGAAC-1	Fibroblast
GCCAATAGTGGTTATG-1	Endothelial_cell
GCCACAATCATGCATA-1	Fibroblast
GCCACAATCTTACTCG-1	Fibroblast
GCCACTAAGGCCGGAA-1	Fibroblast
GCCAGGTTCTAGCGAT-1	Fibroblast
GCCAGGTTCTTTGTAC-1	Fibroblast
GCCATTACAACGTGCT-1	Pericyte
GCCATTACATGTTTGG-1	Cardiomyocyte
GCCCATAAGCTCCCTG-1	Endothelial_cell
GCCCGTTGTGAAACAA-1	Cardiomyocyte
GCCCTCATCAATGTGC-1	Cardiomyocyte
GCCTACTTCAGGAAGC-1	Endothelial_cell
GCCTACTTCCATAAGC-1	Cardiomyocyte
GCCTCAAAGACAGGTA-1	Fibroblast
GCCTCAAAGTAACGAG-1	Fibroblast
GCCTCCATCCTTAGGG-1	Immune_cell
GCCTGACAGCGCATTG-1	Fibroblast
GCCTGCTGTTTGCTGT-1	Endothelial_cell
GCCTTGCGTGAGGTGA-1	Fibroblast
GCCTTTATCATGCGTG-1	Fibroblast
GCGAAGTAGTTGGCCA-1	Endothelial_cell
GCGATATTCTCCTCAA-1	Fibroblast
GCGCGATTCTTAGGGT-1	Endothelial_cell
GCGCTAGGTGGATGTC-1	Fibroblast
GCGGTTATCCTAAGTA-1	Fibroblast
GCGGTTGGTTATCCTA-1	Fibroblast
GCGTGCTAGGAACGCG-1	Immune_cell
GCGTTTCTCATGCATA-1	Endothelial_cell
GCGTTTCTCTTGAGGT-1	Endothelial_cell
GCTAACAGTTTACGTC-1	Cardiomyocyte
GCTAAGAAGTCATTTC-1	Fibroblast
GCTAAGCGTAATAGCT-1	Fibroblast
GCTAAGTTCCTGTTCA-1	Cardiomyocyte
GCTAGCCAGGAGGACT-1	Fibroblast
GCTAGCCAGGCCGGAA-1	Cardiomyocyte
GCTAGCTCATTAGGTT-1	Cardiomyocyte
GCTATCCTCTTGAGGT-1	Cardiomyocyte
GCTCCTTAGTCCTTCA-1	Pericyte
GCTCTGGCAGGAATCG-1	Cardiomyocyte
GCTCTGTTCGCTTCTA-1	Fibroblast
GCTGACCAGACTATTG-1	Fibroblast
GCTGACCAGAGGGACT-1	Endothelial_cell
GCTGAGGAGCGAAGTA-1	Fibroblast
GCTGAGGAGTAGCCAT-1	Cardiomyocyte
GCTGCACAGGTGTCCA-1	Endothelial_cell
GCTGCATCAGGATAAC-1	Fibroblast
GCTGTGATCTGTAAGC-1	Pericyte
GCTTAAATCAGGCCTA-1	Cardiomyocyte
GCTTACCTCAAACCGT-1	Cardiomyocyte
GCTTCGCGTCACCTAT-1	Cardiomyocyte
GCTTCGCGTGAGACTC-1	Fibroblast
GCTTGACCAATCCTAG-1	Pericyte
GCTTGACCAGCAGGTA-1	Endothelial_cell
GCTTGTTGTCACCTAT-1	Fibroblast
GCTTTATTCAATCTCT-1	Fibroblast
GCTTTATTCCGCAAAT-1	Pericyte
GCTTTCATCATAGACC-1	Fibroblast
GCTTTCATCCAAATCA-1	Fibroblast
GGAACGGTCATTCATC-1	Fibroblast
GGAAGCTAGGGCTAAA-1	Cardiomyocyte
GGAATCTTCCAGCACA-1	Fibroblast
GGACAGCCATTGTGGC-1	Fibroblast
GGACATAAGCTCATAA-1	Fibroblast
GGAGCAAGTGGGAACA-1	Pericyte
GGAGCAAGTTACTTGC-1	Pericyte
GGAGCATAGGGCCACT-1	Endothelial_cell
GGATATTGTGCGCATG-1	Immune_cell
GGATTATGTGGAAACG-1	Endothelial_cell
GGATTCAGTTGTGATG-1	Endothelial_cell
GGCCTTCGTCAGGCCA-1	Endothelial_cell
GGCCTTCGTGACCTGG-1	Fibroblast
GGCGATACAGTCTAGC-1	Fibroblast
GGCGCTAGTCAATACG-1	Fibroblast
GGCTAGACAGCACGAA-1	Cardiomyocyte
GGCTTCAAGGAACGCG-1	Endothelial_cell
GGGTCAACAGGCTTCG-1	Fibroblast
GGGTTTGTCGAAGCGG-1	Cardiomyocyte
GGGTTTGTCTTACTCG-1	Fibroblast
GGTAACCGTTCATCTA-1	Cardiomyocyte
GGTAAGGGTTGAAGCC-1	Fibroblast
GGTAATTGTCATTACC-1	Cardiomyocyte
GGTACCGGTCTTTATG-1	Cardiomyocyte
GGTATGTTCTAAGTGC-1	Immune_cell
GGTATTTCATGGTTAT-1	Fibroblast
GGTCAAGCAATAAGCA-1	Fibroblast
GGTCAAGCACGTAAGG-1	Cardiomyocyte
GGTCAATTCAAACACC-1	Cardiomyocyte
GGTCAATTCATTACAG-1	Fibroblast
GGTCCTGCAAGGATTA-1	Pericyte
GGTCGGTTCCTTGAGG-1	Fibroblast
GGTCTTTGTATTGGAT-1	Cardiomyocyte
GGTGAGTAGTGGCGGA-1	Endothelial_cell
GGTGCTGGTCGCGCAA-1	Fibroblast
GGTGCTGGTTAACAGT-1	Pericyte
GGTGTCCAGAACAAGT-1	Fibroblast
GGTGTGACACAGCCTG-1	Immune_cell
GGTGTTGTCACGAATC-1	Fibroblast
GGTGTTGTCGTTCACC-1	Cardiomyocyte
GGTTAATGTTGTGATG-1	Endothelial_cell
GGTTACTAGTAGGCGG-1	Cardiomyocyte
GGTTATGGTGTTTCAC-1	Fibroblast
GGTTCCCGTTTGGCTT-1	Cardiomyocyte
GGTTCTTGTTCCTGAT-1	Adrenal_gland_inflammatory_cell
GGTTTAATCTTGACCC-1	Fibroblast
GTAAAGCCAGCTCAAC-1	Cardiomyocyte
GTACACCCACCATATG-1	Endothelial_cell
GTACCTTGTTACGCAA-1	Cardiomyocyte
GTACCTTGTTCTTTAG-1	Fibroblast
GTACCTTGTTGGTTCT-1	Endothelial_cell
GTACTAATCACACAGT-1	Cardiomyocyte
GTACTAGGTCAGTAAT-1	Fibroblast
GTACTTCGTCCTTCAG-1	Endothelial_cell
GTAGCCATCGTTTCGC-1	Fibroblast
GTAGGAGGTATTTGCC-1	Fibroblast
GTAGTTATCGTAATCA-1	Endothelial_cell
GTATGTGGTTTAGCGA-1	Endothelial_cell
GTATTCAAGTGAGCGG-1	Fibroblast
GTATTGATCACCAATA-1	Fibroblast
GTATTGTCAGTCTAAT-1	Immune_cell
GTCAATATCAAACTCA-1	Fibroblast
GTCAATATCTTGATGA-1	Cardiomyocyte
GTCATCCTCACAGACT-1	Fibroblast
GTCATCCTCAGTGAAG-1	Endothelial_cell
GTCATGCCATAATCAC-1	Endothelial_cell
GTCCAAGTCTTAGGGT-1	Fibroblast
GTCCATTGTTAGCAGC-1	Immune_cell
GTCCATTGTTTGGTTC-1	Pericyte
GTCCGTAAGCATGTTA-1	Cardiomyocyte
GTCCTAGAGGGTCTAT-1	Endothelial_cell
GTCTAACAGTCTTGAA-1	Fibroblast
GTCTAGCCACAGCCAT-1	Smooth_muscle_cell
GTCTAGCCATGTCAAT-1	Fibroblast
GTCTATCGTCCTTTAA-1	Cardiomyocyte
GTCTATGCATTGTGAT-1	Cardiomyocyte
GTCTTTGTCTTGAGGT-1	Endothelial_cell
GTGAACAAGACTATTG-1	Cardiomyocyte
GTGAATCTCCTAATAG-1	Cardiomyocyte
GTGATCAGTACCGGAT-1	Cardiomyocyte
GTGATGAAGGTGCTGC-1	Endothelial_cell
GTGCACGGTAAAGCGG-1	Cardiomyocyte
GTGCACGGTTTGTTGC-1	Cardiomyocyte
GTGCGCAGTTGCTGGG-1	Pericyte
GTGCTGATCTGCAACG-1	Cardiomyocyte
GTGCTTACAGGCCAAA-1	Pericyte
GTGGATGCAAACAACA-1	Endothelial_cell
GTGGATGCACTAAGAA-1	Fibroblast
GTGGCTTCATACCCGG-1	Pericyte
GTGGTTAGTATTGCAG-1	Immune_cell
GTGGTTAGTTACCTGT-1	Cardiomyocyte
GTGTAACTCCCTCATA-1	Fibroblast
GTGTGTTAGGTGTTAC-1	Cardiomyocyte
GTTAAACGTCATTAGG-1	Cardiomyocyte
GTTAAACGTTTCCGGC-1	Fibroblast
GTTAACCAGGCAGGTG-1	Pericyte
GTTAACCAGTAAACCC-1	Endothelial_cell
GTTAACGGTCACTCGC-1	Fibroblast
GTTAATGTCCTTAGGG-1	Fibroblast
GTTAATGTCGGGCCAT-1	Endothelial_cell
GTTACCTGTCCGTGAG-1	Cardiomyocyte
GTTACCTGTTAGGATT-1	Fibroblast
GTTACGCCATAATCGT-1	Endothelial_cell
GTTACTAAGAAAGGAA-1	Fibroblast
GTTACTAAGCTCAATA-1	Adrenal_gland_inflammatory_cell
GTTACTAAGTTTAACG-1	Fibroblast
GTTAGGCGTTAATGAC-1	Fibroblast
GTTCACCTCTAAGGAG-1	Pericyte
GTTCATTTCAGGATGA-1	Cardiomyocyte
GTTCGCGCATAGGCGA-1	Fibroblast
GTTCGCTTCACGTTAA-1	Endothelial_cell
GTTCGCTTCCGGTATG-1	Fibroblast
GTTGCCCGTGAGGTGA-1	Cardiomyocyte
GTTGCGGGTAAAGCAA-1	Fibroblast
GTTGCGGGTGGATTCA-1	Endothelial_cell
GTTGCGGGTTATTGCC-1	Pericyte
GTTGGCCAGACAGGTA-1	Endothelial_cell
GTTGGCGGTCGTAAAT-1	Cardiomyocyte
GTTTACCGTGGATGTC-1	Cardiomyocyte
GTTTGTAAGTCACGAT-1	Fibroblast
TAAGCTATCTGTGAGT-1	Endothelial_cell
TAAGCTGGTTCGCGCT-1	Cardiomyocyte
TAAGGCTTCGGCCATA-1	Fibroblast
TAAGTGCTCAGCCAAT-1	Pericyte
TAATCCGCAATGCGCT-1	Fibroblast
TAATCCGCAGCATGAG-1	Endothelial_cell
TAATGCATCCTCACAC-1	Endothelial_cell
TAATGCATCCTGGTGA-1	Immune_cell
TAATGGACAAGGAATC-1	Cardiomyocyte
TAATGGTGTAACGTGC-1	Endothelial_cell
TAATTGCCAGGTTAAA-1	Endothelial_cell
TACAAGCTCGTACCGA-1	Fibroblast
TACAATGTCAAGGACA-1	Fibroblast
TACAATGTCGCCTAAG-1	Fibroblast
TACAGCTAGCATGTTA-1	Fibroblast
TACAGCTAGTTATCTC-1	Pericyte
TACAGGTTCAAGCGCC-1	Fibroblast
TACAGGTTCCATAATG-1	Cardiomyocyte
TACAGGTTCGTACCGA-1	Fibroblast
TACCAAATCGTTTCCA-1	Fibroblast
TACCGAAGTGTAATAC-1	Fibroblast
TACCGAAGTTGGCCGA-1	Endothelial_cell
TACCGCAAGCACTTGG-1	Cardiomyocyte
TACCGCAAGGGACCTC-1	Immune_cell
TACCGTTGTGCGCATG-1	Fibroblast
TACCTGCTCGTTCACC-1	Endothelial_cell
TACCTTTAGGCGCTAC-1	Pericyte
TACGGATTCACTTCAT-1	Fibroblast
TACGTAATCCACCTGT-1	Cardiomyocyte
TACTGACAGGGACTAA-1	Cardiomyocyte
TACTGAGGTAAGCTTG-1	Fibroblast
TACTGGCCACAGACTC-1	Smooth_muscle_cell
TACTGGCCATTATGAC-1	Fibroblast
TACTTGTTCAGCCAAT-1	Adrenal_gland_inflammatory_cell
TACTTGTTCTATCGCC-1	Fibroblast
TAGAGCCGTTCAAGAT-1	Fibroblast
TAGCATATCTAGCTTT-1	Fibroblast
TAGCCTGAGCTGGACC-1	Endothelial_cell
TAGCGCGGTGATTTGG-1	Fibroblast
TAGCGGACAATAACGA-1	Cardiomyocyte
TAGCGGACAGCTTACA-1	Fibroblast
TAGCTAATCTCGCCTG-1	Fibroblast
TAGGAACCACACCAAC-1	Immune_cell
TAGGAACCAGCTTAGC-1	Adrenal_gland_inflammatory_cell
TAGGAACCATGAAGTA-1	Cardiomyocyte
TAGGAGGGTCTTGCAT-1	Endothelial_cell
TAGGCTAGTAAGCTCA-1	Immune_cell
TAGGCTGTCACAAGCT-1	Pericyte
TAGGTGCGTGCGCAAT-1	Fibroblast
TAGGTGCGTTGGTGAC-1	Fibroblast
TAGGTGCGTTGGTTGA-1	Pericyte
TAGTAACGTTAGGCGT-1	Adrenal_gland_inflammatory_cell
TAGTAAGCACCGGTAT-1	Fibroblast
TAGTACGGTCACCTAT-1	Cardiomyocyte
TAGTAGGAGCTGCACA-1	Fibroblast
TAGTAGGAGTAACAGG-1	Immune_cell
TAGTCAATCAAGTGTC-1	Cardiomyocyte
TAGTGAGAGCATGAAG-1	Cardiomyocyte
TAGTGAGAGTGCACGC-1	Adrenal_gland_inflammatory_cell
TAGTGGCGTGCTTACT-1	Fibroblast
TAGTGTGGTATTGTGG-1	Cardiomyocyte
TATAACCCAGGGAGCT-1	Fibroblast
TATAGCCAGTAACCCG-1	Endothelial_cell
TATAGCTCATGCATAT-1	Endothelial_cell
TATATCCTCCTCAGCT-1	Fibroblast
TATATCCTCTATCGCC-1	Fibroblast
TATCCAGCAATTGACT-1	Pericyte
TATCCGGAGACAAAGT-1	Fibroblast
TATCGCGAGGTGTTAC-1	Pericyte
TATGGATGTATTCGCT-1	Cardiomyocyte
TATGGTCAGCAAGACA-1	Cardiomyocyte
TATGGTCAGCATTATG-1	Cardiomyocyte
TATGTGATCTCGCCTG-1	Cardiomyocyte
TATTACCTCGCGACAC-1	Cardiomyocyte
TATTAGGTCCGGCTAA-1	Fibroblast
TATTCGTTCCCGAAGC-1	Cardiomyocyte
TATTTGCTCAAAGGCA-1	Fibroblast
TATTTGCTCGTTAGCG-1	Fibroblast
TCAAGAACACGCAACT-1	Endothelial_cell
TCAAGAACAGCTACGT-1	Fibroblast
TCAAGAACATCCTGAA-1	Cardiomyocyte
TCAAGGTTCGTTTCCA-1	Endothelial_cell
TCAAGTATCGATAACC-1	Endothelial_cell
TCAATCGCATTATGGT-1	Cardiomyocyte
TCACATAAGCCTTAAA-1	Endothelial_cell
TCACCGGCAACCCTAA-1	Fibroblast
TCACTGACACAACAGG-1	Adrenal_gland_inflammatory_cell
TCACTGACAGTCTATG-1	Fibroblast
TCAGCAAGTGAGAAAC-1	Cardiomyocyte
TCAGCCTTCTTGGATA-1	Cardiomyocyte
TCAGGAGCACTGGCCA-1	Cardiomyocyte
TCAGGTCCAAGTGTTT-1	Cardiomyocyte
TCAGGTCCATCTAGCA-1	Fibroblast
TCAGTAATCCGCTAGA-1	Endothelial_cell
TCAGTGAGTTGCATCT-1	Pericyte
TCATGAGGTTTGAGCA-1	Fibroblast
TCATGCCTCTTACTCG-1	Fibroblast
TCATTGTTCCTCAGCT-1	Cardiomyocyte
TCCAGCAAGCCTAACG-1	Cardiomyocyte
TCCAGGTCACATACTG-1	Adrenal_gland_inflammatory_cell
TCCATATTCACTCGCT-1	Fibroblast
TCCATCATCTTAGCGG-1	Endothelial_cell
TCCATGCTCAAATCGC-1	Fibroblast
TCCATGCTCGTCAAGT-1	Cardiomyocyte
TCCGGAATCCTCGATC-1	Pericyte
TCCGGAATCCTTCTAG-1	Endothelial_cell
TCCGGTAAGTAACCCG-1	Fibroblast
TCCTCTAAGGCATGTT-1	Fibroblast
TCCTGGTTCATCCTGC-1	Cardiomyocyte
TCCTGGTTCCTAAATG-1	Endothelial_cell
TCCTGTTCAAGGGTTG-1	Immune_cell
TCCTTCAAGGTGAAAT-1	Fibroblast
TCCTTTACAGCCAGTT-1	Cardiomyocyte
TCGCATTGTTAGCCAA-1	Smooth_muscle_cell
TCGCCCATCCAGGGAG-1	Pericyte
TCGCTAACAGCATGGA-1	Fibroblast
TCGGTTACAGTTATCG-1	Endothelial_cell
TCGGTTCTCAGCACGC-1	Fibroblast
TCGGTTTGTGGACCTG-1	Fibroblast
TCGTCAACAAAGCGCA-1	Cardiomyocyte
TCGTGCTTCAAACTCA-1	Fibroblast
TCGTGCTTCTAACCAA-1	Fibroblast
TCGTTACGTTCATTTG-1	Fibroblast
TCGTTATTCCGCAAGC-1	Fibroblast
TCTAACCGTGGTTATG-1	Endothelial_cell
TCTAAGGGTAGGTTTG-1	Fibroblast
TCTAAGGGTTACTAGG-1	Cardiomyocyte
TCTAATCTCTCACATT-1	Fibroblast
TCTACCTCACACTAAT-1	Cardiomyocyte
TCTAGCACAATAGCCC-1	Fibroblast
TCTAGCCTCGCTTCTA-1	Pericyte
TCTAGCCTCTTGGATA-1	Endothelial_cell
TCTCACCAGCCTCTGT-1	Immune_cell
TCTGGCTTCAAGACTC-1	Immune_cell
TCTGGCTTCATGCTTT-1	Fibroblast
TCTGTGACAAAGCTAA-1	Fibroblast
TCTTAGTTCCGCTAGA-1	Fibroblast
TCTTAGTTCGTAACGT-1	Endothelial_cell
TCTTCAAGTTACGCGG-1	Pericyte
TGAAACTGTCATCAAG-1	Fibroblast
TGAAACTGTCATGCCC-1	Cardiomyocyte
TGAACAGAGTGAGCAA-1	Cardiomyocyte
TGAAGCAAGCTTGCTC-1	Endothelial_cell
TGACTCCTCGAGGTGG-1	Cardiomyocyte
TGAGAACCATTATGGT-1	Cardiomyocyte
TGAGCAAAGCCGCAGT-1	Fibroblast
TGAGCACGTCGCAATA-1	Immune_cell
TGAGGTGCAATGAATG-1	Fibroblast
TGAGTGAAGGAACACA-1	Endothelial_cell
TGATCAGGTCATGCAA-1	Fibroblast
TGATCGAGTACGCGCA-1	Smooth_muscle_cell
TGATGAACATTCAGCA-1	Fibroblast
TGATTCAAGCCTAACG-1	Fibroblast
TGATTCAAGCTCAAAC-1	Endothelial_cell
TGCACCTTCCCTCGCA-1	Cardiomyocyte
TGCACCTTCTCCATGC-1	Fibroblast
TGCATCCTCGAGGAAC-1	Endothelial_cell
TGCCTGTTCGTTATCT-1	Fibroblast
TGCGGTTCATGAATCT-1	Cardiomyocyte
TGCTATGCACTTCACT-1	Cardiomyocyte
TGCTATGCATCCGTAA-1	Fibroblast
TGCTCAACAAGCTAAA-1	Endothelial_cell
TGCTCAACACCAAAGG-1	Endothelial_cell
TGCTCAACAGCTAACC-1	Fibroblast
TGCTCTCAGCTGGCTA-1	Fibroblast
TGCTCTCAGTTGCCTC-1	Fibroblast
TGCTTCATCCCTCACG-1	Cardiomyocyte
TGCTTCCAGGGCCACT-1	Smooth_muscle_cell
TGCTTTAGTCGAAGTC-1	Fibroblast
TGGACCGGTTGGCGTG-1	Fibroblast
TGGACTAGTAAGTCGC-1	Fibroblast
TGGATTCAGAGCCGCT-1	Adrenal_gland_inflammatory_cell
TGGATTCAGCCTGGTA-1	Endothelial_cell
TGGATTGGTCGTAAAT-1	Fibroblast
TGGATTGGTCTAGCTT-1	Immune_cell
TGGCCAATCTGTGAGT-1	Cardiomyocyte
TGGCCTGCAGGACACA-1	Pericyte
TGGCCTTTCTGCAACG-1	Fibroblast
TGGCTATAGTAGCCAT-1	Cardiomyocyte
TGGCTTTGTGTTGTGA-1	Pericyte
TGGTAAACAGCAAGGC-1	Immune_cell
TGGTCAAGTTTCGCCA-1	Fibroblast
TGGTCAGTCCGTTAAA-1	Pericyte
TGGTGCATCTAAGTCA-1	Fibroblast
TGGTTCCTCGCTTCTA-1	Cardiomyocyte
TGTAACTCAAGTCGCT-1	Cardiomyocyte
TGTAACTCACCTAAGC-1	Immune_cell
TGTATCCGTCCCGGAA-1	Fibroblast
TGTATCGCAATGAGGT-1	Endothelial_cell
TGTCCTGGTACAATGT-1	Cardiomyocyte
TGTGATCAGGAGCACG-1	Fibroblast
TGTGATCAGTTTGTCT-1	Smooth_muscle_cell
TGTGCAAGTCAGTAAT-1	Fibroblast
TGTGCAAGTGCATCGG-1	Pericyte
TGTGGAGCAGGCATCT-1	Immune_cell
TGTGTGAGTCAGGAAG-1	Smooth_muscle_cell
TGTTACTTCGCAACAT-1	Fibroblast
TGTTAGCAGGTCCAAT-1	Immune_cell
TGTTGTGCAAGCTTAT-1	Adrenal_gland_inflammatory_cell
TGTTGTTTCGGTCAAT-1	Immune_cell
TTAAAGGCAGCATGGA-1	Fibroblast
TTAACTGAGGCTAAGA-1	Cardiomyocyte
TTAAGGACACTAAGAA-1	Fibroblast
TTAAGGACATGGCCTG-1	Endothelial_cell
TTAATCGAGCTGCACA-1	Cardiomyocyte
TTACAGCAGTCCTTCA-1	Cardiomyocyte
TTACCGTGTACTGATG-1	Adrenal_gland_inflammatory_cell
TTAGAAGCACCTCGCT-1	Fibroblast
TTAGCGGTCTTAGCCC-1	Pericyte
TTAGGCCCACTATGGC-1	Cardiomyocyte
TTAGGCTAGTTATTCC-1	Fibroblast
TTAGTCAAGTGCACGC-1	Pericyte
TTATAGCCAACTAACT-1	Fibroblast
TTATCCGTCCAAGTTA-1	Endothelial_cell
TTCAGCACATTCCTCG-1	Cardiomyocyte
TTCAGGTAGCGGATTT-1	Fibroblast
TTCATCCCAATTGCGC-1	Cardiomyocyte
TTCATCCCAGGTATTT-1	Fibroblast
TTCATTCAGGCTGGCT-1	Endothelial_cell
TTCCACGGTACCGAAC-1	Cardiomyocyte
TTCCACGGTCCTTCAG-1	Endothelial_cell
TTCCCACAGACAAACG-1	Pericyte
TTCCCACAGGCTGTCA-1	Cardiomyocyte
TTCCTCAAGCTGAGGG-1	Cardiomyocyte
TTCCTTCTCATCACTT-1	Cardiomyocyte
TTCCTTCTCTTGCAGG-1	Endothelial_cell
TTCCTTGAGGCGAAAC-1	Smooth_muscle_cell
TTGACGTAGGCATGTT-1	Cardiomyocyte
TTGACTAAGGAACCAA-1	Endothelial_cell
TTGACTAAGGACCAGG-1	Pericyte
TTGCAGCCACCAGGTT-1	Endothelial_cell
TTGCCCGTCATTAGTG-1	Immune_cell
TTGCCCGTCCACCTGT-1	Endothelial_cell
TTGGCTACATCTTGAG-1	Cardiomyocyte
TTGGCTGAGGACAACA-1	Adrenal_gland_inflammatory_cell
TTGGCTGAGGTCCACA-1	Fibroblast
TTGGGCCAGGCGGATG-1	Cardiomyocyte
TTGGGTTAGGCCAATT-1	Fibroblast
TTGGTGAGTTTAGCGA-1	Immune_cell
TTGTAAGTCCCAGTAG-1	Fibroblast
TTGTAAGTCGACCTGA-1	Cardiomyocyte
TTGTCAAAGCAGGTTT-1	Pericyte
TTGTGTGCAAGGACCA-1	Fibroblast
TTGTTGCGTCCCGGAA-1	Endothelial_cell
TTTAACGAGGTGCGGA-1	Endothelial_cell
TTTAACGAGTAAGTGG-1	Fibroblast
TTTAAGGTCCGTCCAT-1	Fibroblast
TTTACGAAGGTTTGAC-1	Immune_cell
TTTAGCTTCGTTACTT-1	Endothelial_cell
TTTCAGTTCCCGCAAA-1	Cardiomyocyte
TTTCCACCAACCCTAA-1	Fibroblast
TTTCCACCACAGCCTG-1	Cardiomyocyte
TTTCGTCCAAGGCCAA-1	Cardiomyocyte
TTTCGTCCACAGAAAC-1	Cardiomyocyte
TTTCTCACAACTAACT-1	Cardiomyocyte
TTTGCATTCTAGCGAT-1	Endothelial_cell
TTTGCGACAATAGCAA-1	Endothelial_cell
TTTGCGACAGCAAGGC-1	Cardiomyocyte
TTTGCGGAGTGGCGGA-1	Cardiomyocyte
TTTGGCTGTCCGTAGG-1	Fibroblast
TTTGGTGCATAATCCG-1	Cardiomyocyte
TTTGTCCCATGTTGCA-1	Fibroblast
TTTGTCTAGCTTCTCA-1	Endothelial_cell
