Index	Cell_type
AAACCAACAGGAATCG-1	Cardiomyocyte
AAACCGAAGGAACGCG-1	Cardiomyocyte
AAACGCGCAGTAGGTG-1	Cardiomyocyte
AAACGCGCAGTTTGGC-1	Cardiomyocyte
AAACGGATCTTTGTAC-1	Cardiomyocyte
AAAGCGGGTTCACCAT-1	Pericyte
AAAGGAGCACTGACCG-1	Endothelial_cell_1
AAAGGAGCAGGCTTCG-1	Cardiomyocyte
AAAGGCTCAGCAAGTG-1	Cardiomyocyte
AAAGGTTAGGGATGCG-1	Cardiomyocyte
AAAGGTTAGGTAAGGC-1	Cardiomyocyte
AAATCCGGTCATCCTG-1	Endothelial_cell
AAATGCCTCATGCGTG-1	Cardiomyocyte
AAATGCCTCGGGATTT-1	Endothelial_cell
AAATGCCTCTGCAAAC-1	Endothelial_cell
AACAAAGGTGGAAGGC-1	Cardiomyocyte
AACAGATAGTAGCTTA-1	Cardiomyocyte
AACAGATAGTTGGCCA-1	Cardiomyocyte
AACAGCAAGTTAACCA-1	Endothelial_cell
AACAGGATCGCATTAA-1	Cardiomyocyte
AACAGGATCGGCCAGT-1	Cardiomyocyte
AACATCATCCAAGTGT-1	Cardiomyocyte
AACCCGCAGTATTGTG-1	Cardiomyocyte
AACCGGCTCCAGGAAA-1	Endothelial_cell
AACCGGCTCGGCTATG-1	Cardiomyocyte
AACCTCACAATAATGG-1	Cardiomyocyte
AACCTCACACAATGCC-1	Endothelial_cell
AACCTTAAGCTTTGGG-1	Cardiomyocyte
AACCTTAAGGCATGAA-1	Cardiomyocyte
AACCTTAAGTCACGAT-1	Cardiomyocyte
AACCTTAAGTGAAGTG-1	Cardiomyocyte
AACCTTGCACCTAATG-1	Endothelial_cell
AACCTTGCAGCAATAA-1	Cardiomyocyte
AACGACAAGCTCCTAC-1	Cardiomyocyte
AACGACAAGGCATTGT-1	Pericyte
AACGCCCAGTTCCTGC-1	Endothelial_cell
AACGCTAGTGACCTGG-1	Endothelial_cell
AACGGTAAGTCAATCA-1	Endothelial_cell_1
AACTAGCTCTAACTGA-1	Cardiomyocyte
AACTAGTGTCCTTCTC-1	Cardiomyocyte
AACTAGTGTGAGACTC-1	Cardiomyocyte
AAGAACAGTAGACAAA-1	Endothelial_cell
AAGAATCAGCACAGAA-1	Endothelial_cell
AAGACAAGTTGGATCA-1	Endothelial_cell_1
AAGACAAGTTTAACGG-1	Pericyte
AAGACCAAGCCTCTCG-1	Cardiomyocyte
AAGCAAGTCTAAATCG-1	Pericyte
AAGCATGAGGCCTAAT-1	Endothelial_cell
AAGCATGAGGGCTTAT-1	Endothelial_cell
AAGCCTCCAAACTAAG-1	Endothelial_cell
AAGCCTCCAAAGGTAC-1	Immune_cell
AAGCCTCCAGGACCAA-1	Cardiomyocyte
AAGCCTGTCAATCTAG-1	Cardiomyocyte
AAGCCTTAGTTAGTTG-1	Cardiomyocyte
AAGCGAATCCAGGTCA-1	Endothelial_cell_1
AAGCGAATCCTGGCTT-1	Cardiomyocyte
AAGCGCTGTCGCAATA-1	Cardiomyocyte
AAGCGGGTCAGGAACA-1	Endothelial_cell
AAGCTAGAGGCAATAG-1	Cardiomyocyte
AAGGATGTCGCTCCAT-1	Cardiomyocyte
AAGGATTAGGACAACA-1	Cardiomyocyte
AAGGCCCTCGAAGTGA-1	Cardiomyocyte
AAGTAGCCACGTGCTG-1	Cardiomyocyte
AAGTCTATCCCTGATC-1	Cardiomyocyte
AAGTGAAGTAGGTTTG-1	Cardiomyocyte
AAGTGAAGTGCTGTAA-1	Cardiomyocyte
AAGTGAAGTGTTGCAA-1	Cardiomyocyte
AAGTGAAGTTGCACAA-1	Cardiomyocyte
AAGTGCAAGGGATGCG-1	Cardiomyocyte
AAGTGTTGTGGATTAT-1	Cardiomyocyte
AAGTTAGCATCCCTCA-1	Endothelial_cell
AATAACCGTGAGCGAA-1	Cardiomyocyte
AATACCGGTAGTTGGC-1	Endothelial_cell
AATAGCTGTATTGCAG-1	Endothelial_cell
AATAGCTGTATTGGAT-1	Cardiomyocyte
AATAGCTGTTATCCTA-1	Cardiomyocyte
AATCAGGAGGTTAGCT-1	Cardiomyocyte
AATCATCCACCCACAG-1	Immune_cell
AATCATGTCAATGTCA-1	Cardiomyocyte
AATCATGTCCGTAAAC-1	Endothelial_cell_1
AATCCCTGTAATAGCT-1	Cardiomyocyte
AATCGCCCATAAGGAC-1	Endothelial_cell
AATCTCAAGAGGAGTC-1	Cardiomyocyte
AATGCATGTTTGCAGA-1	Endothelial_cell_1
AATTACCCAGCATGAG-1	Cardiomyocyte
AATTACCCATTGTCAG-1	Endothelial_cell
AATTGACGTATTGGAT-1	Cardiomyocyte
AATTGACGTTGCCTCA-1	Endothelial_cell
AATTGGACAAGGTACG-1	Cardiomyocyte
AATTTCCTCGCTTCTA-1	Cardiomyocyte
AATTTCCTCTAAATCG-1	Cardiomyocyte
AATTTGGTCCTTTACG-1	Cardiomyocyte
ACAAAGGTCATTACTC-1	Endothelial_cell
ACAACACTCCAGGTCA-1	Cardiomyocyte
ACACAATGTTAGGCTA-1	Endothelial_cell
ACACAATGTTCCGGCT-1	Pericyte
ACAGCCGGTGTGAGAG-1	Pericyte
ACAGCGCTCGCAGGCT-1	Cardiomyocyte
ACAGTATGTAGTTAAC-1	Cardiomyocyte
ACATCAATCCTCACAC-1	Pericyte
ACATTAGTCCTCATCA-1	Cardiomyocyte
ACATTAGTCTGTGCCT-1	Endothelial_cell_1
ACCAAACTCCTAAGTA-1	Cardiomyocyte
ACCAAACTCGATTATG-1	Cardiomyocyte
ACCAAGTTCTAACTGA-1	Pericyte
ACCAATATCACACAGT-1	Cardiomyocyte
ACCAATATCGGCTATG-1	Cardiomyocyte
ACCAATATCGTTAACA-1	Cardiomyocyte
ACCACACCACCCACCT-1	Endothelial_cell
ACCACATAGTCACCAG-1	Cardiomyocyte
ACCAGGCTCCTCCCTC-1	Cardiomyocyte
ACCATAATCTATGACA-1	Endothelial_cell
ACCATTAAGTAACGAG-1	Cardiomyocyte
ACCCAGGGTAATCCCT-1	Cardiomyocyte
ACCCGCTGTAGGATTT-1	Cardiomyocyte
ACCCGCTGTTACTTCA-1	Cardiomyocyte
ACCCGCTGTTGGTGAC-1	Cardiomyocyte
ACCCGTAAGGTCATTA-1	Cardiomyocyte
ACCCTGTTCTTGCAGG-1	Cardiomyocyte
ACCGAAGCAGCGCTTG-1	Cardiomyocyte
ACCGCAATCGTTATAG-1	Cardiomyocyte
ACCGGCTAGCAGCTAT-1	Cardiomyocyte
ACCGGTTCAGCCAGAA-1	Endothelial_cell
ACCGGTTCATCACTTC-1	Cardiomyocyte
ACCTAAATCTAACTGA-1	Cardiomyocyte
ACCTAAGGTTAGTGAT-1	Endothelial_cell
ACCTACCTCGTGCTTC-1	Cardiomyocyte
ACCTGGATCGGTACGC-1	Cardiomyocyte
ACCTGTTGTAATCACG-1	Pericyte
ACGAACAAGCTTATGA-1	Cardiomyocyte
ACGACTTAGGGACTAA-1	Cardiomyocyte
ACGATTCAGCTGTAAC-1	Pericyte
ACGCACGGTAGTTGGC-1	Pericyte
ACGCTTGAGACAAGTG-1	Cardiomyocyte
ACGGTTAGTTAGGCGT-1	Pericyte
ACGGTTAGTTTAGCTC-1	Immune_cell
ACGTCAAGTGCCTCAC-1	Cardiomyocyte
ACGTCCAAGCACTAAC-1	Cardiomyocyte
ACGTCCAAGGATAAAC-1	Cardiomyocyte
ACGTCCTTCATTACAG-1	Cardiomyocyte
ACGTCCTTCATTCATC-1	Cardiomyocyte
ACGTCCTTCCGCCTAT-1	Cardiomyocyte
ACGTTACAGCCGGTAC-1	Endothelial_cell
ACTAACTCACGGTTTA-1	Pericyte
ACTAATCCAATCCTAG-1	Endothelial_cell_1
ACTAATCCACCATATG-1	Endothelial_cell
ACTAGGCGTTGCAATG-1	Endothelial_cell
ACTATGTCACAACAAA-1	Cardiomyocyte
ACTCACCTCATTACGA-1	Cardiomyocyte
ACTCACCTCCACCTTA-1	Cardiomyocyte
ACTCACCTCCGCAAGC-1	Endothelial_cell
ACTCACCTCTTTGAGA-1	Cardiomyocyte
ACTCGCGCAGGCTAGA-1	Cardiomyocyte
ACTGAAACAGGCCATT-1	Pericyte
ACTGAATGTCATGCAA-1	Endothelial_cell
ACTGAATGTTAAGCGC-1	Cardiomyocyte
ACTTAGGGTTTGAGGC-1	Immune_cell
ACTTAGTCAATAACGA-1	Cardiomyocyte
ACTTAGTCAGCAGGTA-1	Cardiomyocyte
ACTTGAATCCTACCTA-1	Cardiomyocyte
ACTTGAATCCTGATTT-1	Cardiomyocyte
ACTTGCACAGTATGTT-1	Cardiomyocyte
ACTTGTAAGTGAACAG-1	Cardiomyocyte
ACTTGTCGTAAACAAG-1	Endothelial_cell
ACTTGTCGTTAATGCG-1	Cardiomyocyte
ACTTGTCGTTCGCGCT-1	Endothelial_cell_1
ACTTTGTTCTCACTCA-1	Cardiomyocyte
AGAAACTAGCTCCTTA-1	Pericyte
AGAATCGAGACAGGCG-1	Endothelial_cell_1
AGAATCGAGCAAGGGT-1	Endothelial_cell_1
AGAATCGAGGCCATCA-1	Endothelial_cell_1
AGAATCTGTGATTTGG-1	Cardiomyocyte
AGACAATAGACAACAG-1	Endothelial_cell
AGACAATAGGCTGTCA-1	Endothelial_cell
AGAGAGGAGGCTGGCT-1	Cardiomyocyte
AGCAATACAGGACACA-1	Cardiomyocyte
AGCACTTAGGTCCAAT-1	Cardiomyocyte
AGCACTTAGTAACCCG-1	Endothelial_cell_1
AGCAGGTAGCAAGACA-1	Endothelial_cell
AGCATCCCAATAATGG-1	Cardiomyocyte
AGCATCCCAGTTAAAG-1	Cardiomyocyte
AGCATTTCAGCAGGTA-1	Endothelial_cell
AGCATTTCAGCATGAG-1	Cardiomyocyte
AGCCGCTAGCTTGCTC-1	Cardiomyocyte
AGCCGGTTCCGCTAGA-1	Endothelial_cell_1
AGCCTAAGTGTCCTGC-1	Cardiomyocyte
AGCCTAGTCCTCAGCT-1	Cardiomyocyte
AGCGCCTAGGAAGCTA-1	Cardiomyocyte
AGCGCTCAGGAGTCGG-1	Endothelial_cell
AGCGTGCTCCTGATGG-1	Pericyte
AGCTAACTCAAACTCA-1	Pericyte
AGCTAACTCCATAAGC-1	Pericyte
AGCTAACTCGCTATAA-1	Immune_cell
AGCTAACTCGTTAGCG-1	Endothelial_cell
AGCTACGTCCCGCATT-1	Cardiomyocyte
AGCTGCTCATGGAGGC-1	Endothelial_cell
AGCTTAATCCGCCAAA-1	Cardiomyocyte
AGCTTTAAGCGGATAA-1	Cardiomyocyte
AGGAAACGTGACATGC-1	Endothelial_cell_1
AGGAAACGTGTAACCA-1	Endothelial_cell_1
AGGAACCAGCCTGGTA-1	Pericyte
AGGAACCAGTTGTCAA-1	Cardiomyocyte
AGGAACGGTTGCTGGG-1	Endothelial_cell
AGGACGTAGCTCAAAC-1	Cardiomyocyte
AGGACTAAGCACCACA-1	Cardiomyocyte
AGGACTAAGCCACAAT-1	Endothelial_cell
AGGACTAAGCGAGGTG-1	Cardiomyocyte
AGGAGCTAGGTGTTAC-1	Cardiomyocyte
AGGCAATCAGCTCAAC-1	Cardiomyocyte
AGGCAGGTCTATTGTC-1	Pericyte
AGGCCCAGTCGTAAAT-1	Endothelial_cell
AGGCTAAAGTGGCGGA-1	Endothelial_cell
AGGCTAGCATCAATCG-1	Cardiomyocyte
AGGTAACCAATCCTGA-1	Endothelial_cell
AGGTATTGTTTCGCGC-1	Cardiomyocyte
AGGTCAAAGCTGAGGG-1	Pericyte
AGGTCAAAGGCCTGGT-1	Cardiomyocyte
AGGTCATTCCCTCGCA-1	Endothelial_cell
AGGTCATTCTTCAATC-1	Pericyte
AGGTCCGGTAAGCTCA-1	Endothelial_cell_1
AGGTCCGGTGGTTATG-1	Cardiomyocyte
AGGTCCGGTTAGGCTA-1	Endothelial_cell
AGGTCTTAGTAATCCA-1	Cardiomyocyte
AGGTGAATCATGCAAC-1	Endothelial_cell_1
AGGTGAATCTCACTCA-1	Cardiomyocyte
AGGTGAGGTCCCGGAA-1	Endothelial_cell_1
AGGTTACTCAAACTCA-1	Endothelial_cell
AGGTTAGAGGGCTTTG-1	Pericyte
AGGTTTGGTATTGCAG-1	Cardiomyocyte
AGTAAACAGCTCAAAC-1	Cardiomyocyte
AGTAACCTCTAAGTGC-1	Cardiomyocyte
AGTAACGAGTCAATCA-1	Immune_cell
AGTAACGAGTTCCCGT-1	Endothelial_cell
AGTAATGCAATCATGT-1	Endothelial_cell
AGTAATGCACCAACCG-1	Endothelial_cell
AGTAGGATCGTCAAGT-1	Cardiomyocyte
AGTCAAGAGCTCGCTT-1	Endothelial_cell
AGTCCTGAGAGAGGAG-1	Cardiomyocyte
AGTCCTGAGGACCTCA-1	Cardiomyocyte
AGTCCTGAGGAGTAAT-1	Cardiomyocyte
AGTCCTTGTAAGCTCA-1	Cardiomyocyte
AGTGAACCATAAACCT-1	Endothelial_cell
AGTGATGAGTAACGGA-1	Endothelial_cell
AGTGCCGGTTGCCTCA-1	Cardiomyocyte
AGTGCGGAGTAAGAAC-1	Immune_cell
AGTGTGGCACAATGCC-1	Endothelial_cell
AGTGTTTCACGGTACT-1	Endothelial_cell
AGTGTTTCAGGGAGCT-1	Endothelial_cell_1
AGTTATGTCCTTAATC-1	Cardiomyocyte
AGTTATGTCGAAGCGG-1	Endothelial_cell
AGTTGTCAGACAAGTG-1	Cardiomyocyte
AGTTGTCAGTTTGCGG-1	Cardiomyocyte
AGTTTGATCTTAGGGT-1	Cardiomyocyte
AGTTTGCAGTCAGGCC-1	Pericyte
ATAAGCCTCAACCAAC-1	Cardiomyocyte
ATAAGTCGTAGCCATA-1	Cardiomyocyte
ATAAGTCGTCACAGCG-1	Endothelial_cell_1
ATAAGTCGTCATTGAG-1	Cardiomyocyte
ATAATGGCAACTAGGG-1	Cardiomyocyte
ATACCGGTCTTGCAGG-1	Endothelial_cell
ATAGCATGTTAGGCGT-1	Cardiomyocyte
ATAGGTACACTATGGC-1	Immune_cell
ATATGCTCAATTGAGA-1	Cardiomyocyte
ATCACAATCATGCTCC-1	Cardiomyocyte
ATCACAATCATTATGG-1	Cardiomyocyte
ATCACAATCGGTAACT-1	Endothelial_cell
ATCACACAGCTACTGG-1	Immune_cell
ATCACCCTCCAGCACA-1	Cardiomyocyte
ATCACTAAGGGCTTAT-1	Endothelial_cell
ATCCAACAGGGCCATC-1	Endothelial_cell
ATCCAACAGTTATGGC-1	Pericyte
ATCCCGCGTCCACAAA-1	Pericyte
ATCCTTAGTTTAGTCC-1	Cardiomyocyte
ATCGCCCGTACAAAGA-1	Cardiomyocyte
ATCGGCCAGTCATCCC-1	Endothelial_cell
ATCTATGAGTTAGTGC-1	Endothelial_cell_1
ATGAAGCCAATCCTGA-1	Cardiomyocyte
ATGAAGCCAGAAATGC-1	Endothelial_cell
ATGACGAAGGGATGAC-1	Endothelial_cell
ATGACGAAGTCTCACC-1	Pericyte
ATGAGCCGTAGCTAGC-1	Cardiomyocyte
ATGAGCCGTGATTACG-1	Cardiomyocyte
ATGATGACAGAACCGA-1	Endothelial_cell
ATGATGGAGGTCGAGG-1	Cardiomyocyte
ATGCAGGCACGTAAGG-1	Endothelial_cell
ATGCATTCAGTCTATG-1	Cardiomyocyte
ATGCCTGAGCTGTCAG-1	Cardiomyocyte
ATGCGATTCGCAATCG-1	Cardiomyocyte
ATGCTTAAGGAATAAC-1	Endothelial_cell
ATGGCTGTCCAGGTTG-1	Cardiomyocyte
ATGGCTTAGTGCACGC-1	Cardiomyocyte
ATGGTCTAGGGACTAA-1	Immune_cell
ATGGTGCGTGGGTACT-1	Cardiomyocyte
ATGTAAGCAACTAACT-1	Cardiomyocyte
ATGTTCAAGTAACCCG-1	Cardiomyocyte
ATTACCGCAAACCTAT-1	Endothelial_cell_1
ATTACCGCACAATGCC-1	Cardiomyocyte
ATTACCGCATGTCAGC-1	Endothelial_cell_1
ATTACTGAGTTATCTC-1	Endothelial_cell
ATTAGGTGTAAGGTCC-1	Cardiomyocyte
ATTAGGTGTTTATCTG-1	Cardiomyocyte
ATTAGTCCAGCAAGGC-1	Cardiomyocyte
ATTAGTCCATGAAATG-1	Endothelial_cell
ATTATGGTCATCCTCA-1	Cardiomyocyte
ATTCCGGAGGCAAGTA-1	Endothelial_cell
ATTCCGGAGGTTAGAG-1	Cardiomyocyte
ATTCCTAGTAATCACG-1	Cardiomyocyte
ATTCCTAGTGGACCTG-1	Cardiomyocyte
ATTCCTCCAAGGGTTG-1	Endothelial_cell
ATTCCTCCAAGGTAAC-1	Cardiomyocyte
ATTCCTCCATATTGAC-1	Cardiomyocyte
ATTCGTTTCTCCTCAA-1	Cardiomyocyte
ATTGAAGCAATTTAGC-1	Cardiomyocyte
ATTGAAGCATAATTGC-1	Endothelial_cell
ATTGAAGCATCGCTTT-1	Cardiomyocyte
ATTGACTCATCACTTC-1	Cardiomyocyte
ATTGCACAGCAGGTGG-1	Cardiomyocyte
ATTGCACAGGTGAAGC-1	Cardiomyocyte
ATTGCAGGTTGACTTC-1	Endothelial_cell_1
ATTGCTCGTCATTGAG-1	Cardiomyocyte
ATTGGTTCAGAGGCTA-1	Cardiomyocyte
ATTGTCCGTGCAACTA-1	Cardiomyocyte
ATTGTGATCCAGGGAG-1	Cardiomyocyte
ATTTGCAAGGTCCTAG-1	Endothelial_cell
ATTTGCGCACGTGCTG-1	Cardiomyocyte
ATTTGTGAGCAAACCT-1	Cardiomyocyte
ATTTGTGAGCAAGGAC-1	Immune_cell
CAAACAACAATAGCCC-1	Cardiomyocyte
CAAACACTCAGCTAAC-1	Cardiomyocyte
CAAACACTCCGTGACA-1	Cardiomyocyte
CAAACATGTATCTGGA-1	Cardiomyocyte
CAAACATGTGTTAGCA-1	Cardiomyocyte
CAAACTGGTTTGTGGA-1	Cardiomyocyte
CAAAGCGCAGTAATAG-1	Cardiomyocyte
CAACCCTTCATAACCA-1	Cardiomyocyte
CAACTAATCAATGTCA-1	Endothelial_cell
CAACTAGGTGTTAAAC-1	Endothelial_cell
CAAGGCTGTGCGCAAT-1	Cardiomyocyte
CAAGGTTTCTAGCGAT-1	Pericyte
CAAGTAACAAGGATTA-1	Pericyte
CAAGTGAAGGAAGCAC-1	Endothelial_cell
CAAGTTATCCTTGCGT-1	Endothelial_cell
CAATAAGCAGCTAACC-1	Cardiomyocyte
CAATATGTCATGCGTG-1	Endothelial_cell
CAATATGTCCGTTAAA-1	Cardiomyocyte
CAATCCCTCATGGTGT-1	Endothelial_cell
CAATCCTGTGTCCTGC-1	Endothelial_cell_1
CAATGAACAAGCCAGA-1	Cardiomyocyte
CAATGACTCGTTACTT-1	Endothelial_cell_1
CAATGTCAGGTGAAAT-1	Cardiomyocyte
CACATAATCGAAGTGA-1	Cardiomyocyte
CACATACAGGTCTTGG-1	Cardiomyocyte
CACCGGTAGCACGTTG-1	Pericyte
CACCGGTAGTAACGAG-1	Cardiomyocyte
CACGCAATCCAGGTTG-1	Cardiomyocyte
CACTAGCCAAGGCCAA-1	Cardiomyocyte
CACTTAAAGGGCCACT-1	Endothelial_cell
CAGATTCAGCCAAATC-1	Cardiomyocyte
CAGATTCAGGCTATGT-1	Cardiomyocyte
CAGCATTAGGCTAAGA-1	Cardiomyocyte
CAGCCTAAGCGAGTAA-1	Endothelial_cell
CAGCCTTTCCTAGTTT-1	Endothelial_cell
CAGCTAAGTTTGCTGT-1	Cardiomyocyte
CAGCTATAGCCTGTGA-1	Endothelial_cell
CAGGACACACAGGAAT-1	Cardiomyocyte
CAGGACCTCACTCAAA-1	Endothelial_cell
CAGGATGCAGGCTGTT-1	Cardiomyocyte
CAGGCTATCCTAGTTT-1	Pericyte
CAGGTGGAGCCTAACG-1	Pericyte
CAGGTTTAGTGAGAGC-1	Cardiomyocyte
CAGGTTTAGTGAGGGT-1	Cardiomyocyte
CAGTACCCAATGAATG-1	Cardiomyocyte
CATAAGCTCCTAATAG-1	Cardiomyocyte
CATAGGCGTCAAGTAT-1	Cardiomyocyte
CATAGGCGTTTAGCGA-1	Endothelial_cell_1
CATAGGTTCATTGTCT-1	Cardiomyocyte
CATAGGTTCCTACCTA-1	Endothelial_cell_1
CATAGTCAGCGGGCAA-1	Endothelial_cell_1
CATAGTCAGGCGGGTA-1	Cardiomyocyte
CATAGTCAGTCGCTAG-1	Pericyte
CATATCGCATGGTTAT-1	Cardiomyocyte
CATCAATCAGCTCATA-1	Pericyte
CATCAATCAGTAATAG-1	Cardiomyocyte
CATCACACATGTCAGC-1	Cardiomyocyte
CATCAGCCAGGCTACT-1	Cardiomyocyte
CATCATAAGCCGCTAA-1	Cardiomyocyte
CATCATGCATAAACCT-1	Endothelial_cell_1
CATCCCAGTGAATCGC-1	Cardiomyocyte
CATCCTCAGTTTAACG-1	Cardiomyocyte
CATCCTGGTGAGCAAG-1	Endothelial_cell
CATCGCTTCCAACTGG-1	Endothelial_cell
CATCGCTTCGACAAAG-1	Cardiomyocyte
CATCGCTTCTCACAAA-1	Cardiomyocyte
CATGCAAGTGCCTCAC-1	Endothelial_cell
CATGCATAGAGGAGGA-1	Pericyte
CATGCATAGGTGCGGA-1	Cardiomyocyte
CATGCGCAGCTCGCTT-1	Cardiomyocyte
CATGCGCAGTTATTCC-1	Endothelial_cell_1
CATGGATTCAATGTGC-1	Cardiomyocyte
CATGGATTCCCGTTAC-1	Endothelial_cell
CATTATGAGCATGAAG-1	Cardiomyocyte
CATTGTAAGCTCGCTT-1	Cardiomyocyte
CATTGTGCAATCCCTT-1	Endothelial_cell
CATTGTGCATTATGGT-1	Cardiomyocyte
CATTTGTTCATAACCA-1	Endothelial_cell
CATTTGTTCCTCGATC-1	Endothelial_cell
CATTTGTTCCTGATTT-1	Endothelial_cell
CCAAACTAGCCTGTTC-1	Cardiomyocyte
CCAACCAAGGAACGGT-1	Endothelial_cell
CCAATATCACACAATT-1	Cardiomyocyte
CCACACAAGCCTGACA-1	Cardiomyocyte
CCACACAAGTAGCGGG-1	Endothelial_cell
CCAGACTCAGGGAGCT-1	Cardiomyocyte
CCAGCCTGTATTACCC-1	Cardiomyocyte
CCAGGAACACCTAAGC-1	Cardiomyocyte
CCAGTTTGTGAGCGAA-1	Cardiomyocyte
CCATAATCAATAACCT-1	Endothelial_cell
CCATAGCCAGCCTAAC-1	Endothelial_cell
CCATCATGTAATCGTG-1	Cardiomyocyte
CCATCATGTATTTGGG-1	Cardiomyocyte
CCCAAACCAAGGTGGC-1	Cardiomyocyte
CCCAAACCACCCACCT-1	Cardiomyocyte
CCCAAATAGGACTTAC-1	Endothelial_cell
CCCAATTGTACCGTTT-1	Cardiomyocyte
CCCAGTTTCTCACAAA-1	Endothelial_cell
CCCAGTTTCTCGACCT-1	Cardiomyocyte
CCCGCAACAAGGTACG-1	Endothelial_cell_1
CCCGTAAAGACAGGTA-1	Cardiomyocyte
CCCGTTGTCCCGTTTA-1	Cardiomyocyte
CCCTCACCACAATACT-1	Endothelial_cell
CCCTGGACATCCCTCA-1	Cardiomyocyte
CCCTGGACATTAAGCT-1	Endothelial_cell
CCCTTAATCCCTCATA-1	Cardiomyocyte
CCCTTAATCCTAATTC-1	Cardiomyocyte
CCGCAAATCGGTACGC-1	Cardiomyocyte
CCGCAAGGTAAATTGC-1	Cardiomyocyte
CCGCAAGGTCAAAGAA-1	Endothelial_cell_1
CCGCTAAAGGTAGCTT-1	Cardiomyocyte
CCGCTTAGTGATGAAA-1	Cardiomyocyte
CCGTGCTGTATGGTGC-1	Endothelial_cell
CCGTTAACAACACCTA-1	Cardiomyocyte
CCGTTTGGTAGCCATA-1	Cardiomyocyte
CCGTTTGGTCGTAATG-1	Cardiomyocyte
CCGTTTGGTTGCGCGA-1	Cardiomyocyte
CCTAAAGGTGAGACTC-1	Cardiomyocyte
CCTAAGCCACCTGTAA-1	Endothelial_cell
CCTAAGTAGTTTGGTA-1	Endothelial_cell
CCTAATCGTGACATAT-1	Cardiomyocyte
CCTAATCGTTAACACG-1	Cardiomyocyte
CCTACTTCAATATAGG-1	Endothelial_cell
CCTACTTCAGGAACAT-1	Cardiomyocyte
CCTATAGCAGCCAGAA-1	Cardiomyocyte
CCTATTTAGAAACTGG-1	Cardiomyocyte
CCTATTTAGGGTTAGA-1	Cardiomyocyte
CCTATTTAGGTGAAAT-1	Endothelial_cell
CCTCAAACATAATGAG-1	Endothelial_cell_1
CCTCAATGTGCTTTAC-1	Endothelial_cell
CCTCAGTTCATTAGTG-1	Cardiomyocyte
CCTCAGTTCTAACCTT-1	Cardiomyocyte
CCTCCTGAGATAACCC-1	Pericyte
CCTCCTGAGCTAAGTC-1	Cardiomyocyte
CCTGACTTCACGAATC-1	Immune_cell
CCTGAGTCAAGTCGCT-1	Pericyte
CCTGCTCCAACTGGCT-1	Cardiomyocyte
CCTGGATCAGATAGAC-1	Endothelial_cell_1
CCTGGTAAGAACAAGT-1	Cardiomyocyte
CCTGTAACATAATGTC-1	Cardiomyocyte
CCTGTAACATTAGGTT-1	Cardiomyocyte
CCTGTATGTCCAAGAC-1	Cardiomyocyte
CCTGTTGGTCGAAGTC-1	Cardiomyocyte
CCTTAGTGTAGCTGGT-1	Cardiomyocyte
CCTTAGTGTGTAACCA-1	Cardiomyocyte
CCTTATGTCGAGCTAT-1	Cardiomyocyte
CCTTCAATCATTACAG-1	Endothelial_cell
CCTTCAATCTAATCCT-1	Endothelial_cell
CCTTCAGGTCCTTCAG-1	Cardiomyocyte
CCTTCAGGTGTTTGCT-1	Endothelial_cell_1
CCTTCGGTCCTGGTCT-1	Endothelial_cell
CCTTGCGTCCGGGACT-1	Endothelial_cell_1
CCTTGCGTCGATTTAG-1	Cardiomyocyte
CCTTGCGTCGCTAGTG-1	Cardiomyocyte
CGAAATGAGCGAGCGA-1	Cardiomyocyte
CGAAATGAGCTGGACC-1	Cardiomyocyte
CGAACAAAGCATGAAG-1	Cardiomyocyte
CGAACAAAGGATCCGC-1	Cardiomyocyte
CGAAGCGAGCAATAGG-1	Endothelial_cell_1
CGAAGGCCAACCTGGT-1	Cardiomyocyte
CGAAGGCCAAGGTACG-1	Cardiomyocyte
CGAATCTAGCCATCAG-1	Cardiomyocyte
CGACAAGCACTTAGGC-1	Endothelial_cell_1
CGACCTGCATAGCTGC-1	Cardiomyocyte
CGACTAAGTAGGATTT-1	Endothelial_cell
CGAGGTGAGACAAGTG-1	Endothelial_cell_1
CGAGGTGAGACACTTA-1	Cardiomyocyte
CGAGTCGGTGTGTGGT-1	Cardiomyocyte
CGATCCTTCGCAACAT-1	Endothelial_cell_1
CGATGTCCAAAGCCTC-1	Cardiomyocyte
CGATTCCTCCTTGCAC-1	Pericyte
CGATTTGCAGGCAAGC-1	Cardiomyocyte
CGATTTGCATTGTCAG-1	Cardiomyocyte
CGCAATAGTAGTTGGC-1	Endothelial_cell
CGCAATCCAGCAATAA-1	Cardiomyocyte
CGCAATTAGAGAAGGG-1	Cardiomyocyte
CGCAATTAGCATTATG-1	Cardiomyocyte
CGCACCACACTTCACT-1	Cardiomyocyte
CGCATATAGCGAGGTG-1	Cardiomyocyte
CGCATATAGTTAGCTA-1	Pericyte
CGCATGATCGTTACTT-1	Cardiomyocyte
CGCATTACAGTTTGGC-1	Immune_cell
CGCATTTGTAGGTTGC-1	Cardiomyocyte
CGCATTTGTGAGCAAG-1	Cardiomyocyte
CGCCTGTGTAAAGCAA-1	Cardiomyocyte
CGCGATTCATTAAAGG-1	Cardiomyocyte
CGCGGATTCGACCTGA-1	Cardiomyocyte
CGCGGATTCTTAGCGG-1	Cardiomyocyte
CGCGGATTCTTAGTGA-1	Endothelial_cell_1
CGCTAACCATGAATCT-1	Cardiomyocyte
CGCTCAGCAGAAATTG-1	Cardiomyocyte
CGCTCCATCTAAGTCA-1	Cardiomyocyte
CGCTTAACATAGCTTG-1	Endothelial_cell_1
CGCTTAACATATTGAC-1	Cardiomyocyte
CGCTTACTCATGCTCC-1	Cardiomyocyte
CGCTTACTCCTAAGAC-1	Cardiomyocyte
CGCTTGCGTAGCAGCT-1	Endothelial_cell
CGGACAACACTGGCTG-1	Endothelial_cell
CGGACAACAGGATAAC-1	Cardiomyocyte
CGGACCTAGCCTCTGT-1	Endothelial_cell
CGGAGTCTCCAGGGAG-1	Endothelial_cell
CGGAGTCTCGATAACC-1	Cardiomyocyte
CGGCAATGTTAAGCGC-1	Cardiomyocyte
CGGCCATAGGTAACGA-1	Cardiomyocyte
CGGCTCACACTAGCGT-1	Endothelial_cell
CGGGACAAGCTCCTAC-1	Cardiomyocyte
CGGGACAAGCTTTGGG-1	Pericyte
CGGGACAAGGCTAAGA-1	Cardiomyocyte
CGGGACAAGGTAGCTT-1	Endothelial_cell_1
CGGGACAAGTTCCCGT-1	Cardiomyocyte
CGGGCTTAGCAAGATG-1	Cardiomyocyte
CGGGCTTAGTGCACGC-1	Cardiomyocyte
CGGTGAACAGAGGCTA-1	Cardiomyocyte
CGGTTATAGGCAGGTG-1	Endothelial_cell
CGGTTATAGGTGCTGC-1	Cardiomyocyte
CGGTTCCGTTTGGGCG-1	Cardiomyocyte
CGGTTGGGTATTGCAG-1	Endothelial_cell_1
CGGTTTCTCGCTAGTG-1	Cardiomyocyte
CGGTTTCTCTTGAGGT-1	Cardiomyocyte
CGGTTTGAGCATCCAG-1	Cardiomyocyte
CGTAATGGTAATGGAA-1	Cardiomyocyte
CGTAGCGGTCACAGCG-1	Cardiomyocyte
CGTAGCGGTCCAAGAC-1	Cardiomyocyte
CGTAGCGGTGCATTTC-1	Cardiomyocyte
CGTAGTTAGGACAATG-1	Cardiomyocyte
CGTCAATAGTCAGTAC-1	Endothelial_cell_1
CGTCATTGTAAGTCGC-1	Endothelial_cell
CGTGACATCATGCAAC-1	Pericyte
CGTGCACAGGAGGGTT-1	Endothelial_cell
CGTGCTTTCATCCACC-1	Cardiomyocyte
CGTTAACAGCATGTTA-1	Cardiomyocyte
CGTTAACAGTTAGTTG-1	Cardiomyocyte
CGTTAGGTCTTTGAGA-1	Cardiomyocyte
CGTTAGTAGTTAACCA-1	Endothelial_cell
CGTTATTTCAGCATTA-1	Cardiomyocyte
CGTTGCGCAAGGGTTG-1	Pericyte
CGTTGCGCAATCTCTC-1	Pericyte
CTAAAGCTCCCTGATC-1	Cardiomyocyte
CTAAATGTCTGCAACG-1	Cardiomyocyte
CTAATCCGTAACCTAG-1	Endothelial_cell
CTAATGTCAAAGGCCA-1	Cardiomyocyte
CTACCGGCAGCCAGAA-1	Cardiomyocyte
CTACCTCAGAAGCTAG-1	Endothelial_cell
CTAGCGGGTCACAGCG-1	Endothelial_cell_1
CTAGTAATCAACAAGG-1	Cardiomyocyte
CTAGTAATCACAGCGC-1	Cardiomyocyte
CTAGTAATCTGTAAGC-1	Cardiomyocyte
CTAGTCGAGAATCTCA-1	Cardiomyocyte
CTAGTCGAGGAGCATA-1	Endothelial_cell
CTAGTGAGTCCGTGAG-1	Endothelial_cell
CTATGAGGTTTAAAGC-1	Pericyte
CTATGATCACAACCTA-1	Cardiomyocyte
CTATGTTTCCGCCAAA-1	Endothelial_cell
CTATGTTTCCGGTTAG-1	Cardiomyocyte
CTATTACTCACCTGCT-1	Cardiomyocyte
CTATTACTCACTAGGT-1	Cardiomyocyte
CTATTACTCCTACCTA-1	Cardiomyocyte
CTATTCAGTGTCACGG-1	Cardiomyocyte
CTATTGAAGCACAGCC-1	Endothelial_cell
CTCAATAAGTTAGGCT-1	Cardiomyocyte
CTCACACTCCAAGTTA-1	Cardiomyocyte
CTCAGGATCACCTGCT-1	Pericyte
CTCATCATCCCTGTTA-1	Cardiomyocyte
CTCATGACAACAGCCT-1	Pericyte
CTCATGCTCACTCAAA-1	Endothelial_cell
CTCATTTAGTGGCGGA-1	Cardiomyocyte
CTCCAACTCCAGGTTG-1	Endothelial_cell_1
CTCCGTCCAGAGGGAG-1	Cardiomyocyte
CTCCTAATCATAACGC-1	Cardiomyocyte
CTCCTGAGTAGTAAGA-1	Pericyte
CTCGCTCCACATAACT-1	Cardiomyocyte
CTCGTTATCGGTCAAT-1	Cardiomyocyte
CTCTAAGCAATTAGGA-1	Cardiomyocyte
CTCTAGCTCAATCATG-1	Endothelial_cell
CTCTAGCTCGGGCCAT-1	Pericyte
CTCTATGTCATGTCAA-1	Endothelial_cell
CTCTATGTCCCGAAGC-1	Cardiomyocyte
CTCTGTTCAACAGGTG-1	Cardiomyocyte
CTCTGTTCAACCGCCA-1	Cardiomyocyte
CTCTTGATCTGCAAAC-1	Cardiomyocyte
CTCTTGATCTTGAGCG-1	Endothelial_cell
CTGAAACTCCGCCTCA-1	Pericyte
CTGATCACAAGTAAGC-1	Cardiomyocyte
CTGCAATAGGCCTTAG-1	Pericyte
CTGCAATAGTTTGGGT-1	Cardiomyocyte
CTGGATGTCGGTTTCC-1	Endothelial_cell
CTGGTAAGTATTCGCT-1	Cardiomyocyte
CTGGTCAAGCGATACT-1	Cardiomyocyte
CTGGTCAAGCGATAGA-1	Cardiomyocyte
CTGGTCAAGTGAGAGC-1	Cardiomyocyte
CTGGTTACACGCAACT-1	Pericyte
CTGTAACAGGACCTTG-1	Cardiomyocyte
CTGTAACAGGACTTAC-1	Pericyte
CTGTATTTCCAACTGG-1	Endothelial_cell
CTGTTTAGTCACACCC-1	Cardiomyocyte
CTGTTTAGTGACATAT-1	Cardiomyocyte
CTTAATGAGAGAGCCG-1	Endothelial_cell
CTTAGGAGTAAGGTTT-1	Cardiomyocyte
CTTATGTTCATGTTTC-1	Cardiomyocyte
CTTATGTTCCGCTAGA-1	Endothelial_cell
CTTATTGGTTTGTGGA-1	Cardiomyocyte
CTTCAAGCAGGTTATT-1	Cardiomyocyte
CTTCAAGCATAGTCAT-1	Cardiomyocyte
CTTCAATTCGGTTCCT-1	Pericyte
CTTCAATTCTGGCAAT-1	Cardiomyocyte
CTTCACTCAGCCAGTT-1	Cardiomyocyte
CTTCAGGAGTAGGCGG-1	Cardiomyocyte
CTTCGCGTCATTCATC-1	Cardiomyocyte
CTTCTCAAGTATTGGC-1	Cardiomyocyte
CTTGAACAGCAGGTTT-1	Endothelial_cell
CTTGAATCACACAATT-1	Cardiomyocyte
CTTGACGAGGCAGGTG-1	Endothelial_cell_1
CTTGCAACAAGTAAGC-1	Endothelial_cell
CTTGCTCAGGTTAGCT-1	Cardiomyocyte
CTTTAGGCATGAAATG-1	Endothelial_cell
CTTTAGTTCGAAGTAG-1	Endothelial_cell
CTTTGGGAGGAGTCTT-1	Cardiomyocyte
GAAACTGAGATGGAGC-1	Endothelial_cell_1
GAACACAAGTTTAACG-1	Cardiomyocyte
GAACCAAAGGCTACAT-1	Cardiomyocyte
GAACCAGCACCATATG-1	Endothelial_cell
GAACCTGTCATCCTGC-1	Pericyte
GAACCTTAGTTAGAGG-1	Cardiomyocyte
GAACTTATCACGCGGT-1	Cardiomyocyte
GAAGCCTGTTCCGGCT-1	Cardiomyocyte
GAAGGATGTAAGGTCC-1	Endothelial_cell
GAAGGCCCACCAGGTT-1	Cardiomyocyte
GAAGGCCCAGAGGGAG-1	Cardiomyocyte
GAAGTAAGTTAAGCCA-1	Cardiomyocyte
GAAGTATAGGCATGTT-1	Cardiomyocyte
GAAGTATAGTAACTCA-1	Pericyte
GAAGTCAAGTTTAACG-1	Endothelial_cell
GAAGTGATCATTAGTG-1	Endothelial_cell
GAAGTGATCGGTTACG-1	Endothelial_cell_1
GAAGTGATCTAAATCG-1	Cardiomyocyte
GAAGTGATCTGTGCAG-1	Cardiomyocyte
GAATTTGTCTAAGTCA-1	Endothelial_cell
GACACCGGTGGACATC-1	Cardiomyocyte
GACACCGGTGGGAACA-1	Cardiomyocyte
GACATAGAGTGTGATC-1	Cardiomyocyte
GACCGAACAATTAGGA-1	Cardiomyocyte
GACCGTTCAAACCTTG-1	Cardiomyocyte
GACCTAAGTAACAGGG-1	Immune_cell
GACCTCAAGGCAAGTA-1	Cardiomyocyte
GACCTGATCTACCTGC-1	Cardiomyocyte
GACCTGCAGGTCCAAT-1	Cardiomyocyte
GACGCAACAATCCTAG-1	Cardiomyocyte
GACTAATGTCAGGCAT-1	Endothelial_cell
GACTAATGTGTCCAAA-1	Endothelial_cell
GACTAATGTTCAAGCA-1	Cardiomyocyte
GACTATTCACACCAAC-1	Cardiomyocyte
GACTCACCAGGCTAAG-1	Cardiomyocyte
GAGAGGCGTGTTCCCA-1	Cardiomyocyte
GAGCGAAGTTGTTCAC-1	Cardiomyocyte
GAGCGATAGCTCATAA-1	Pericyte
GAGCGGTCAGTCTAAT-1	Cardiomyocyte
GAGCGGTCATGGAGGC-1	Endothelial_cell
GAGCTGCTCATAACTG-1	Immune_cell
GAGCTGCTCGCTAGCA-1	Cardiomyocyte
GAGCTGCTCTTAGCGG-1	Cardiomyocyte
GAGCTGCTCTTGAGGT-1	Endothelial_cell
GAGCTTAGTTAGGTTG-1	Cardiomyocyte
GAGGCTACAGGCATGA-1	Cardiomyocyte
GAGGCTACATAATGAG-1	Cardiomyocyte
GAGGCTTGTTAGCATG-1	Cardiomyocyte
GAGGTACAGCAGGCCT-1	Endothelial_cell
GAGGTAGGTCACAGCG-1	Endothelial_cell
GAGGTTAAGCAAGACA-1	Endothelial_cell
GAGGTTAAGTAACCAC-1	Cardiomyocyte
GAGTCAAAGAATGACG-1	Cardiomyocyte
GAGTCAAAGAGAGCCG-1	Cardiomyocyte
GAGTCATTCAACAAGG-1	Cardiomyocyte
GAGTGAGGTGATTACG-1	Cardiomyocyte
GAGTGATCACAAACTT-1	Cardiomyocyte
GAGTGTTTCATAACTG-1	Cardiomyocyte
GAGTTGCGTGCGCATG-1	Pericyte
GATAAAGGTTAGGTTG-1	Pericyte
GATAAAGGTTATCGAG-1	Endothelial_cell
GATAACGAGCGGCTGT-1	Cardiomyocyte
GATAAGCCACTGACTA-1	Cardiomyocyte
GATCAGGCAAGCGAGC-1	Cardiomyocyte
GATCCGTCAGCAGGTA-1	Cardiomyocyte
GATCGATTCAGCACGC-1	Cardiomyocyte
GATCGATTCCTCGATC-1	Cardiomyocyte
GATCGATTCCTGGTGA-1	Cardiomyocyte
GATCGCTCAGCTAACC-1	Pericyte
GATGACTTCGATCAGT-1	Cardiomyocyte
GATGACTTCGCTAGCA-1	Endothelial_cell
GATGCATTCTTAAGTG-1	Cardiomyocyte
GATGCATTCTTGATGA-1	Cardiomyocyte
GATGGCTGTCCTAATC-1	Cardiomyocyte
GATTACGGTGACCTGG-1	Endothelial_cell_1
GATTACTCAGTCTAGC-1	Cardiomyocyte
GATTAGCTCACCAATA-1	Cardiomyocyte
GATTAGTGTTAGCAGC-1	Endothelial_cell_1
GATTCAATCACCAATA-1	Endothelial_cell
GATTCATCAGGCTAGA-1	Cardiomyocyte
GATTCCTGTCCGCTGT-1	Cardiomyocyte
GATTCCTGTGTTTGTC-1	Cardiomyocyte
GATTCGCCACAGAACG-1	Endothelial_cell
GATTCGCCATAAGTCT-1	Cardiomyocyte
GATTGATGTCATCCTG-1	Cardiomyocyte
GATTGGTTCCTGGCTT-1	Cardiomyocyte
GATTGTTCATCACAGC-1	Cardiomyocyte
GATTTGCAGGCTACAT-1	Cardiomyocyte
GATTTGCAGTAACCAC-1	Cardiomyocyte
GCAAACCGTGAGCGAA-1	Cardiomyocyte
GCAAACTTCGCCTGTT-1	Cardiomyocyte
GCAACAGCATAGACTT-1	Cardiomyocyte
GCAACAGCATTAGGTT-1	Cardiomyocyte
GCAAGTCGTCCTAATC-1	Cardiomyocyte
GCACATTAGTTATGTG-1	Endothelial_cell
GCACGAACAGGTATTT-1	Cardiomyocyte
GCACGGTTCCTAATTC-1	Endothelial_cell
GCAGCCAGTTTCCTCC-1	Cardiomyocyte
GCAGCTATCCTCAGTC-1	Endothelial_cell_1
GCAGGAAGTTTCCTCC-1	Pericyte
GCAGGACCATGCTCCC-1	Cardiomyocyte
GCAGGCTTCGGTTCCT-1	Endothelial_cell
GCAGGTGAGGTAAGGC-1	Cardiomyocyte
GCATCCTTCTTGCATT-1	Cardiomyocyte
GCATTAGGTAGCCTCC-1	Pericyte
GCCAATTAGTCATCCC-1	Cardiomyocyte
GCCACAATCCTGGCTT-1	Cardiomyocyte
GCCACACAGTTCCTGC-1	Cardiomyocyte
GCCACTAAGTTATTCC-1	Endothelial_cell
GCCAGGAAGTCATGCG-1	Cardiomyocyte
GCCCATAAGGGTCCAC-1	Cardiomyocyte
GCCCGTTGTGATCAGC-1	Endothelial_cell
GCCTAATAGTGCTGTG-1	Endothelial_cell_1
GCCTACTTCCTTCTAG-1	Cardiomyocyte
GCCTACTTCGCACACA-1	Cardiomyocyte
GCCTATTGTATTGAGT-1	Endothelial_cell
GCCTCAAAGCTAGAAG-1	Cardiomyocyte
GCCTCAAAGTTAGACC-1	Cardiomyocyte
GCCTCGACACATAACT-1	Endothelial_cell_1
GCCTGTGCAGCCTAAC-1	Cardiomyocyte
GCCTGTGCATGGTTAT-1	Cardiomyocyte
GCCTGTGCATGTCAAT-1	Endothelial_cell
GCCTTACTCCAAGTGT-1	Endothelial_cell_1
GCCTTACTCTTGCAAA-1	Cardiomyocyte
GCCTTAGAGCCTGACA-1	Cardiomyocyte
GCCTTTGGTACCAGGT-1	Endothelial_cell_1
GCCTTTGGTATTTGCC-1	Cardiomyocyte
GCGATATTCTAATCTC-1	Endothelial_cell
GCGATTTAGTCACCAG-1	Cardiomyocyte
GCGCCTTGTGTGCACG-1	Cardiomyocyte
GCGCGATTCGATTTAG-1	Cardiomyocyte
GCGCGATTCTCACATT-1	Cardiomyocyte
GCGCTAGGTGCATCGG-1	Endothelial_cell
GCGCTTAAGGACGTAA-1	Endothelial_cell
GCGGAACCACAAAGGT-1	Cardiomyocyte
GCGGAACCAGTTATGT-1	Endothelial_cell
GCGGATACATCGCTTT-1	Cardiomyocyte
GCGGGTTTCATGTCAA-1	Cardiomyocyte
GCGGTTATCAGCAAGA-1	Endothelial_cell_1
GCGGTTATCCGCTAGA-1	Cardiomyocyte
GCGTAACGTAACGAGG-1	Endothelial_cell
GCGTAACGTGGATTCA-1	Cardiomyocyte
GCGTGCTAGGCGTAAA-1	Cardiomyocyte
GCTAACAGTAACAGGG-1	Cardiomyocyte
GCTAACCCAGCCAGTT-1	Cardiomyocyte
GCTAACCCAGCTCATA-1	Endothelial_cell_1
GCTAAGAAGAACAAGT-1	Cardiomyocyte
GCTAAGAAGCGCATTG-1	Cardiomyocyte
GCTAATATCATAACCA-1	Endothelial_cell
GCTAGCGGTAGCAGCT-1	Endothelial_cell
GCTAGCGGTTAACAGT-1	Cardiomyocyte
GCTAGTGTCCTTAGGG-1	Cardiomyocyte
GCTATCCTCAAACCTA-1	Cardiomyocyte
GCTATCCTCTCACAAA-1	Cardiomyocyte
GCTCCTTAGCAATAGG-1	Endothelial_cell_1
GCTCCTTAGTAACCCG-1	Endothelial_cell_1
GCTCGATCAATTAACC-1	Cardiomyocyte
GCTCGATCACGAATCC-1	Cardiomyocyte
GCTCTGGCATCCAGGT-1	Cardiomyocyte
GCTCTGTTCAATCTCT-1	Cardiomyocyte
GCTGAGGAGCTCCTAC-1	Cardiomyocyte
GCTGCAATCAGCTAAC-1	Endothelial_cell
GCTGCATCACTTAACG-1	Endothelial_cell
GCTGCATCAGCTTAAT-1	Cardiomyocyte
GCTGGATGTGAAACAA-1	Cardiomyocyte
GCTGTACCAACTAGCC-1	Cardiomyocyte
GCTGTACCATGAGTTT-1	Endothelial_cell
GCTGTGCAGGCGGATG-1	Endothelial_cell_1
GCTTAACAGCGATAGA-1	Immune_cell
GCTTATCGTTAAGGCC-1	Cardiomyocyte
GCTTGACCACCTGGTG-1	Cardiomyocyte
GCTTGACCACTAGCGT-1	Cardiomyocyte
GCTTTGTGTCATCCTG-1	Cardiomyocyte
GCTTTGTGTGGATGTC-1	Cardiomyocyte
GCTTTGTGTTGTTGTC-1	Endothelial_cell
GGAACAATCTCAATTC-1	Cardiomyocyte
GGAACCTGTGGACCTG-1	Endothelial_cell
GGAAGCTAGGCAAGTA-1	Cardiomyocyte
GGACAGCCAAGCTTAT-1	Endothelial_cell
GGACATAAGAAGCTAG-1	Endothelial_cell_1
GGACGGATCGGCTATG-1	Cardiomyocyte
GGACGGATCTTTGACT-1	Cardiomyocyte
GGACTAAAGAAACTGG-1	Cardiomyocyte
GGACTAAAGCATGTCG-1	Cardiomyocyte
GGAGTCTGTAATCACG-1	Cardiomyocyte
GGAGTGAGTTCACCAT-1	Cardiomyocyte
GGATACTTCGAGCTAT-1	Cardiomyocyte
GGATACTTCGGTCAGC-1	Endothelial_cell
GGATATTGTCATCAAG-1	Cardiomyocyte
GGATATTGTGATTACG-1	Pericyte
GGATGGCCAAGGTGCA-1	Cardiomyocyte
GGATGGCCACCTGGTG-1	Cardiomyocyte
GGATGGCCATATTGAC-1	Endothelial_cell
GGATGTAAGGCCTTAG-1	Cardiomyocyte
GGATGTAAGGGTCCAC-1	Cardiomyocyte
GGCAAATCAATCCTAG-1	Endothelial_cell
GGCAAGCCAGGAATCG-1	Cardiomyocyte
GGCAGGATCATTCATC-1	Immune_cell
GGCATTAGTTCCGGCT-1	Cardiomyocyte
GGCATTGTCACGCCAA-1	Cardiomyocyte
GGCATTGTCGCTAAAC-1	Endothelial_cell
GGCATTGTCGTTTCTG-1	Endothelial_cell
GGCCGTTAGCGGATTT-1	Cardiomyocyte
GGCCTCTGTGCAACTA-1	Endothelial_cell
GGCCTCTGTTAATGCG-1	Cardiomyocyte
GGCCTTAAGCGATAAG-1	Endothelial_cell
GGCCTTAAGGTAAGGC-1	Cardiomyocyte
GGCGATACACAATGTT-1	Cardiomyocyte
GGCGATACAGTTTCTC-1	Endothelial_cell
GGCGATACATAATCGT-1	Endothelial_cell
GGCGCTAGTCCTCCAA-1	Cardiomyocyte
GGCGGTAAGAGGGACT-1	Pericyte
GGCGGTAAGTAGGATG-1	Endothelial_cell_1
GGCGTTATCACAGACT-1	Cardiomyocyte
GGCTAGTGTGTGCACG-1	Pericyte
GGCTATGTCTAGCTTT-1	Endothelial_cell
GGCTATGTCTTAGCGG-1	Cardiomyocyte
GGCTCACAGCACAGAA-1	Cardiomyocyte
GGCTGAGAGACAGGCG-1	Immune_cell
GGCTTAAGTCCTTTAA-1	Pericyte
GGCTTCAAGTAAGTGG-1	Pericyte
GGGCATGAGAATGACG-1	Cardiomyocyte
GGGCATGAGCATGACT-1	Endothelial_cell_1
GGGCATGAGCCGCTAA-1	Cardiomyocyte
GGGCATGAGCCTGGTA-1	Cardiomyocyte
GGGCATTGTGGATGTC-1	Cardiomyocyte
GGGCCTAGTCAGGAAG-1	Endothelial_cell
GGGCCTAGTCCTAAGA-1	Cardiomyocyte
GGGCCTAGTCCTTAGT-1	Cardiomyocyte
GGGTCAACACCAACCG-1	Cardiomyocyte
GGGTCAACATGGAGGC-1	Cardiomyocyte
GGGTCACTCAGCACGC-1	Cardiomyocyte
GGGTCACTCATTATGG-1	Cardiomyocyte
GGGTGAAGTATTACCC-1	Endothelial_cell
GGGTGTTGTAGGTTTG-1	Endothelial_cell
GGGTGTTGTTGCAATG-1	Endothelial_cell
GGGTTATTCTTTAAGG-1	Cardiomyocyte
GGGTTATTCTTTGTAC-1	Cardiomyocyte
GGGTTTGTCACAAGCT-1	Cardiomyocyte
GGTAAACCAAACAACA-1	Cardiomyocyte
GGTAAACCACACAATT-1	Cardiomyocyte
GGTAACTTCAAACCTA-1	Cardiomyocyte
GGTACTAGTGTCCAGG-1	Cardiomyocyte
GGTATTTCAGCCAGTT-1	Cardiomyocyte
GGTCAAGCAATTAGCT-1	Cardiomyocyte
GGTCAATTCATCCTAT-1	Endothelial_cell_1
GGTCAGGAGCGGCTGT-1	Cardiomyocyte
GGTCAGGAGTTTGAGC-1	Endothelial_cell_1
GGTCCGTAGGATCCGC-1	Endothelial_cell
GGTCGGTTCCCTCAGT-1	Cardiomyocyte
GGTCTTGAGGCCTTAG-1	Endothelial_cell
GGTCTTTGTATTGAGT-1	Cardiomyocyte
GGTGAGCCAAACTGTT-1	Cardiomyocyte
GGTGATTTCCTCCATA-1	Pericyte
GGTGCTGGTGTTGCAA-1	Cardiomyocyte
GGTGTCCAGCTCCTTA-1	Endothelial_cell
GGTGTCCAGCTGAGGG-1	Endothelial_cell_1
GGTGTTGTCATTGCAA-1	Immune_cell
GGTTAGCGTACGGTAC-1	Cardiomyocyte
GGTTCCCGTAATGGCC-1	Endothelial_cell_1
GGTTCCCGTCTATCGT-1	Endothelial_cell_1
GGTTGCATCTTTGACT-1	Pericyte
GGTTGGTGTTACTTGC-1	Cardiomyocyte
GGTTGGTGTTTGAGCA-1	Cardiomyocyte
GGTTTAATCTTGGATA-1	Endothelial_cell
GGTTTCTGTAGCCTAA-1	Cardiomyocyte
GTAAGCGCATGCTCCC-1	Pericyte
GTAAGGTCAATTGAGA-1	Cardiomyocyte
GTAAGGTCACCTAATG-1	Cardiomyocyte
GTACACCCAGGCCAAA-1	Cardiomyocyte
GTACGTAGTAAGCTCA-1	Endothelial_cell
GTACTAATCGGTCAGC-1	Endothelial_cell
GTACTTCGTTCCTCCT-1	Endothelial_cell_1
GTAGGCGAGAATGACG-1	Cardiomyocyte
GTAGTTATCACTAATG-1	Cardiomyocyte
GTATTCAAGCTGGAAA-1	Cardiomyocyte
GTATTCAAGGCAACAA-1	Cardiomyocyte
GTATTCAAGTATCGCG-1	Endothelial_cell
GTATTGCAGCATGACT-1	Cardiomyocyte
GTATTGTCAGGCCAAA-1	Cardiomyocyte
GTCAAACTCCTGTTCA-1	Cardiomyocyte
GTCAAACTCGTTACTT-1	Cardiomyocyte
GTCAGGCTCCGCATGA-1	Cardiomyocyte
GTCATCACAAGCCACT-1	Endothelial_cell
GTCATCACATAAGTTC-1	Cardiomyocyte
GTCATCACATGAGCAG-1	Cardiomyocyte
GTCATGCCACAAAGGT-1	Cardiomyocyte
GTCCAAGTCTCCTCAA-1	Cardiomyocyte
GTCCATTGTTTGGTTC-1	Cardiomyocyte
GTCCGTAAGTCCTGAG-1	Endothelial_cell
GTCCTCAGTAATCGCA-1	Cardiomyocyte
GTCCTCCCATAATTGC-1	Cardiomyocyte
GTCGCAATCAGTTCCC-1	Endothelial_cell
GTCGCAATCATCAGTA-1	Endothelial_cell
GTCGCAATCCAAGTTA-1	Cardiomyocyte
GTCGGTTCAGTACCGT-1	Endothelial_cell_1
GTCTAATCAGGCGATA-1	Cardiomyocyte
GTCTAATCATAAGTCT-1	Endothelial_cell
GTCTAGCCACTGACTA-1	Cardiomyocyte
GTCTATGCATAAACCT-1	Cardiomyocyte
GTCTCACTCATCCTCA-1	Pericyte
GTGAGCGAGCGATACT-1	Cardiomyocyte
GTGAGGAGTAAATTGC-1	Cardiomyocyte
GTGATCAGTTAACGGC-1	Cardiomyocyte
GTGATGAAGAATCGCT-1	Cardiomyocyte
GTGATGAAGCTAATCA-1	Endothelial_cell
GTGATGAAGTGCTGTG-1	Cardiomyocyte
GTGCATTAGGTCGAGG-1	Endothelial_cell
GTGCATTAGTTTGTCT-1	Endothelial_cell
GTGCTCAAGCCAGTAT-1	Endothelial_cell_1
GTGCTCAAGCCTAATA-1	Cardiomyocyte
GTGCTGATCTCCATGC-1	Endothelial_cell
GTGCTGGGTGCATTAG-1	Cardiomyocyte
GTGCTTACAATAGTCT-1	Immune_cell
GTGCTTCTCAAATCGC-1	Endothelial_cell_1
GTGCTTCTCAGCACGC-1	Endothelial_cell
GTGGTTAGTCCCGAAG-1	Cardiomyocyte
GTGTAACTCTTGAGGT-1	Cardiomyocyte
GTGTCCAAGGTAGCTT-1	Cardiomyocyte
GTGTCCAAGGTGAAAT-1	Cardiomyocyte
GTGTGTTAGACTTATG-1	Cardiomyocyte
GTGTTACAGCTACTGG-1	Cardiomyocyte
GTGTTACAGGATTGAG-1	Endothelial_cell_1
GTGTTCCTCAGTTCCC-1	Cardiomyocyte
GTGTTCCTCGGTCAAT-1	Endothelial_cell
GTTAAACGTAACGGGA-1	Endothelial_cell
GTTAACGGTCCTCCAA-1	Cardiomyocyte
GTTAAGCTCCCGTTGT-1	Cardiomyocyte
GTTAAGCTCTTTAAGG-1	Endothelial_cell
GTTAAGTGTTATGTGG-1	Cardiomyocyte
GTTACAGGTAGGTTTG-1	Cardiomyocyte
GTTACCTGTCCCGAAG-1	Cardiomyocyte
GTTACGTAGTGCTGTG-1	Cardiomyocyte
GTTACTCGTGTTGTGA-1	Endothelial_cell
GTTCACCTCGGTTTGG-1	Cardiomyocyte
GTTCCTGGTTTGAGGC-1	Cardiomyocyte
GTTCCTTCATCGTTCT-1	Cardiomyocyte
GTTCTCATCAAGCCTG-1	Cardiomyocyte
GTTCTCATCTATGACA-1	Cardiomyocyte
GTTCTTGTCTCCTCTT-1	Cardiomyocyte
GTTGCCCGTGTCCTGC-1	Endothelial_cell
GTTGCTGAGGGCCACT-1	Cardiomyocyte
GTTGCTGAGGTCTTGG-1	Endothelial_cell_1
GTTGGAGCAATTAACC-1	Pericyte
GTTGGCCAGAGGAGTC-1	Cardiomyocyte
GTTGGCCAGGCTGGCT-1	Cardiomyocyte
GTTGGCCAGGTCAAAG-1	Cardiomyocyte
GTTGGCGGTAAGGTCC-1	Endothelial_cell
GTTGTGAGTAGCCTAA-1	Cardiomyocyte
GTTGTGAGTCAAAGGG-1	Cardiomyocyte
GTTGTGAGTTCATTTG-1	Cardiomyocyte
GTTGTTGCAGAGAGCC-1	Pericyte
GTTGTTGCAGGATGGC-1	Cardiomyocyte
GTTTAGCAGCAGCTAT-1	Cardiomyocyte
GTTTAGCAGTATTGGC-1	Endothelial_cell
GTTTCAGCACCTGCTC-1	Cardiomyocyte
GTTTGCTGTGTTTCAC-1	Cardiomyocyte
GTTTGTAAGCATCCAG-1	Cardiomyocyte
GTTTGTTTCAATCTAG-1	Cardiomyocyte
GTTTGTTTCAATGTGC-1	Cardiomyocyte
TAAACAGCATAGCGAG-1	Cardiomyocyte
TAAAGCCTCCTGTTCA-1	Cardiomyocyte
TAACAAGCACAAAGCG-1	Endothelial_cell_1
TAAGCCAGTACTGAAT-1	Endothelial_cell
TAAGCCAGTTTGAGCA-1	Cardiomyocyte
TAAGCCTAGAACAAGT-1	Cardiomyocyte
TAAGCTGGTTCGCTTG-1	Cardiomyocyte
TAATCACCAGCCAGTT-1	Endothelial_cell
TAATCACCATAAGCAA-1	Cardiomyocyte
TAATCCGCACAAAGCG-1	Endothelial_cell
TAATGCATCCAACTGG-1	Cardiomyocyte
TAATGCATCCGGGACT-1	Endothelial_cell_1
TAATGCATCGGTCAAT-1	Cardiomyocyte
TAATTGCCACCTATAG-1	Cardiomyocyte
TAATTGCCATGTTGTG-1	Cardiomyocyte
TACAACATCCTTAAGA-1	Cardiomyocyte
TACAACATCTCCTCAA-1	Cardiomyocyte
TACAATGTCCGCTAGA-1	Cardiomyocyte
TACAGGTTCCTTCTAG-1	Pericyte
TACATCAAGGCAAGTA-1	Cardiomyocyte
TACATCAAGTCAATCA-1	Cardiomyocyte
TACCCGGCAGTAAAGC-1	Cardiomyocyte
TACCCGGCATGGAGGC-1	Cardiomyocyte
TACCGCAAGCACTAGT-1	Cardiomyocyte
TACCGCAAGGAGCACG-1	Cardiomyocyte
TACCGTTGTTTGCTGT-1	Pericyte
TACCTCATCCCGTTAC-1	Endothelial_cell
TACCTCATCGCCTGTT-1	Cardiomyocyte
TACCTTAGTGTCACGG-1	Endothelial_cell_1
TACGGATTCTAATTGG-1	Endothelial_cell
TACGGTTAGCTAAGTC-1	Cardiomyocyte
TACGGTTAGCTGGCTA-1	Cardiomyocyte
TACGGTTAGGACAACA-1	Cardiomyocyte
TACGTACAGCAACATC-1	Pericyte
TACGTACAGTTTGCGG-1	Endothelial_cell_1
TACTAAGTCTTGTCTG-1	Cardiomyocyte
TACTCAAAGTCAGTAC-1	Cardiomyocyte
TACTCGCTCCCGTTAC-1	Endothelial_cell_1
TACTGACAGTATTGCA-1	Endothelial_cell_1
TACTGCACACATACTG-1	Cardiomyocyte
TACTGGCCACAATGCC-1	Immune_cell
TAGACCAGTAAGCACC-1	Cardiomyocyte
TAGACCAGTGAGGTAG-1	Cardiomyocyte
TAGAGCCGTTTGACCT-1	Cardiomyocyte
TAGCAGGCATGAGTTT-1	Endothelial_cell
TAGCCGGGTCGCAAAC-1	Cardiomyocyte
TAGCCTTGTACCGAAC-1	Endothelial_cell
TAGCCTTGTGTCCTGC-1	Pericyte
TAGCGCGGTTACGCAA-1	Cardiomyocyte
TAGCGGACATCACTTC-1	Pericyte
TAGCGGACATCCCTCA-1	Endothelial_cell
TAGCGGCTCGGTTACG-1	Cardiomyocyte
TAGGCTAGTAATGGAA-1	Pericyte
TAGGCTTAGTATCGCG-1	Cardiomyocyte
TAGGGTTTCCTCCATA-1	Cardiomyocyte
TAGGTGCGTCCTAACT-1	Cardiomyocyte
TAGGTTGGTGGACCTG-1	Endothelial_cell
TAGTAACGTTACGCGG-1	Endothelial_cell
TAGTACGGTAACGGGA-1	Cardiomyocyte
TAGTAGGAGGTCATTA-1	Cardiomyocyte
TAGTCAATCATGCATA-1	Cardiomyocyte
TAGTGGCGTCACGAAC-1	Cardiomyocyte
TAGTGTGGTCATGCCC-1	Cardiomyocyte
TAGTGTGGTTGCAATG-1	Endothelial_cell
TATAACCCAGGCGATA-1	Cardiomyocyte
TATATCCTCCGCCTAT-1	Endothelial_cell_1
TATCCAGCACAATTAC-1	Cardiomyocyte
TATCCAGCAGCTAACC-1	Cardiomyocyte
TATCCAGCATGAGTTT-1	Cardiomyocyte
TATCCGGAGCACAGGG-1	Endothelial_cell
TATCGCACATGAGCAG-1	Cardiomyocyte
TATGACATCACACAGT-1	Cardiomyocyte
TATGACATCCTGGCTT-1	Cardiomyocyte
TATGACTCAAGGTGCA-1	Cardiomyocyte
TATGCATCAAGTGTTT-1	Endothelial_cell
TATGCATCATTATGCG-1	Cardiomyocyte
TATGGCCCAGCAATAA-1	Cardiomyocyte
TATGGCCCAGGCTACT-1	Pericyte
TATGGTCAGTAAGTGG-1	Endothelial_cell
TATGTGATCATGGCTG-1	Cardiomyocyte
TATTACCTCATTGCGG-1	Cardiomyocyte
TATTACCTCGATTCTT-1	Cardiomyocyte
TATTACCTCTGCAAAC-1	Endothelial_cell_1
TATTAGCCAACTGGGA-1	Endothelial_cell
TATTAGGTCGCTTGCT-1	Endothelial_cell
TATTTGGAGAGGCTAA-1	Cardiomyocyte
TCAAACCAGACTTATG-1	Cardiomyocyte
TCAAGACTCAAGCGCC-1	Endothelial_cell
TCAAGACTCAATGTCA-1	Cardiomyocyte
TCAAGACTCCCTGGTT-1	Cardiomyocyte
TCAAGCTAGCCAAATC-1	Cardiomyocyte
TCAAGCTAGCTTTGTT-1	Cardiomyocyte
TCAAGGAAGTTAGTGC-1	Cardiomyocyte
TCAAGTATCATTGTCT-1	Cardiomyocyte
TCAAGTATCCGTTAAA-1	Cardiomyocyte
TCAAGTATCGCAAACT-1	Cardiomyocyte
TCAATCGCAATGCCTA-1	Cardiomyocyte
TCACCGGCATGATTGT-1	Pericyte
TCACCTCAGAACCTAC-1	Endothelial_cell_1
TCACTGACACCTATAG-1	Cardiomyocyte
TCAGCCTTCCACCTTA-1	Cardiomyocyte
TCAGCGATCGGGATTT-1	Cardiomyocyte
TCAGGAGCACATTAAC-1	Endothelial_cell_1
TCAGGAGCAGGATGGC-1	Cardiomyocyte
TCAGGTCCACGGTTTA-1	Cardiomyocyte
TCATAACCAAGGTGCA-1	Cardiomyocyte
TCATAACCAGCAAGTG-1	Cardiomyocyte
TCATGAGGTAAGCTCA-1	Cardiomyocyte
TCATGAGGTATTGGAT-1	Cardiomyocyte
TCATGCCTCGTTAGCG-1	Endothelial_cell_1
TCATGCCTCTAGCGAT-1	Cardiomyocyte
TCATGCCTCTTTGACT-1	Cardiomyocyte
TCATTGCGTTGTCCAT-1	Cardiomyocyte
TCATTGTTCCTGCGAA-1	Cardiomyocyte
TCATTTGGTTCATTTG-1	Cardiomyocyte
TCCAGCAAGTAACAGG-1	Cardiomyocyte
TCCAGCAAGTAGCGCC-1	Endothelial_cell
TCCAGGATCTGTAAGC-1	Endothelial_cell_1
TCCATAAAGGAACACA-1	Endothelial_cell
TCCATCATCCCTGTTA-1	Endothelial_cell
TCCATGCTCTAGCTAA-1	Cardiomyocyte
TCCATTGTCCCTGTTA-1	Cardiomyocyte
TCCCTGGTCTCGCCTG-1	Cardiomyocyte
TCCGCCATCTCACTCA-1	Pericyte
TCCTAGTGTTTAACCC-1	Cardiomyocyte
TCCTCAATCCTCATCA-1	Endothelial_cell
TCCTCTAAGCATGGTT-1	Cardiomyocyte
TCCTGTTCACAGCCTG-1	Cardiomyocyte
TCCTTCAAGCCTAATA-1	Cardiomyocyte
TCCTTCAAGCGATAGA-1	Cardiomyocyte
TCCTTCAAGCTATGAC-1	Endothelial_cell
TCCTTCAAGCTCCTAC-1	Cardiomyocyte
TCCTTCAAGTTCCCGT-1	Cardiomyocyte
TCCTTTACAGGCATGA-1	Cardiomyocyte
TCGCATTGTTGTTGTC-1	Cardiomyocyte
TCGGTAAGTGCTGTAA-1	Cardiomyocyte
TCGGTTACACCGTTCC-1	Endothelial_cell_1
TCGGTTACACGTAATT-1	Cardiomyocyte
TCGGTTCTCAGGCTAT-1	Endothelial_cell
TCGTGCTTCCATAATG-1	Cardiomyocyte
TCGTTACGTTACCTGT-1	Cardiomyocyte
TCGTTATTCGCAGGCT-1	Endothelial_cell
TCTAACCGTTATTGCC-1	Cardiomyocyte
TCTAACTTCGGCTAGC-1	Cardiomyocyte
TCTAGCACAGAGGCTA-1	Cardiomyocyte
TCTAGCGAGGAGTCGG-1	Endothelial_cell
TCTAGCGAGGTTTGAC-1	Cardiomyocyte
TCTCAATTCCATTACT-1	Cardiomyocyte
TCTCAATTCCGCAAAT-1	Cardiomyocyte
TCTGGCTTCCAAGTGT-1	Cardiomyocyte
TCTTAGTTCATTAGCA-1	Cardiomyocyte
TCTTGACGTACGGTAC-1	Cardiomyocyte
TGAAACTGTGTTTGAG-1	Endothelial_cell
TGAACAGAGACTATTG-1	Cardiomyocyte
TGAACAGAGGGTGGAT-1	Endothelial_cell
TGACTCCTCATGTGGT-1	Endothelial_cell_1
TGACTCCTCGTCCTTA-1	Cardiomyocyte
TGACTTAAGCTTTGGG-1	Cardiomyocyte
TGACTTAAGTAACTCA-1	Cardiomyocyte
TGACTTCGTCAAAGGG-1	Cardiomyocyte
TGAGCCGGTCTTGCAT-1	Endothelial_cell
TGAGCTTAGTAACTCA-1	Cardiomyocyte
TGAGGGCCATAGCGAG-1	Cardiomyocyte
TGAGTGAAGCTTCCCG-1	Cardiomyocyte
TGATCACAGCGCATTG-1	Cardiomyocyte
TGATGACTCCGCAAGC-1	Cardiomyocyte
TGATGACTCCTGAGTG-1	Cardiomyocyte
TGATTAGTCCTCGATC-1	Cardiomyocyte
TGCAATATCACTCGCT-1	Pericyte
TGCAATATCCCGCCTA-1	Cardiomyocyte
TGCAATATCGCACAAT-1	Endothelial_cell_1
TGCACACCATAGTCAT-1	Cardiomyocyte
TGCATTAAGGAGCATA-1	Cardiomyocyte
TGCATTAAGTTCCTGC-1	Endothelial_cell
TGCGATTAGCTTAACA-1	Cardiomyocyte
TGCTAACAGTGAGCAA-1	Endothelial_cell
TGCTCCGTCACAGACT-1	Cardiomyocyte
TGCTCCGTCTTGCATT-1	Cardiomyocyte
TGCTGGATCCTTGAGG-1	Cardiomyocyte
TGCTTTAGTAACAGGG-1	Cardiomyocyte
TGGACAAAGATTGAGG-1	Cardiomyocyte
TGGATTCAGGAAACTG-1	Pericyte
TGGATTGGTCAGGAAG-1	Cardiomyocyte
TGGATTGGTTTGCTGT-1	Cardiomyocyte
TGGCCAATCGGCTAGC-1	Cardiomyocyte
TGGCCATCATAGACTT-1	Cardiomyocyte
TGGCCTGCACCTCGCT-1	Cardiomyocyte
TGGCTAAGTGAGAAAC-1	Cardiomyocyte
TGGCTATAGCCGGTAC-1	Endothelial_cell_1
TGGGCATGTTTGAGGC-1	Cardiomyocyte
TGGGCCTAGCATGCAT-1	Cardiomyocyte
TGGGCCTAGCTGGACC-1	Endothelial_cell
TGGGCCTAGGCAGGTG-1	Endothelial_cell
TGGTAAACAAGCGATG-1	Endothelial_cell
TGGTCAAGTCAATACG-1	Cardiomyocyte
TGGTCAAGTTTGAGGC-1	Immune_cell
TGGTCCTTCGGGATTT-1	Cardiomyocyte
TGGTGATTCGTCCTTA-1	Cardiomyocyte
TGGTTAATCGTCAAGT-1	Cardiomyocyte
TGGTTCCTCTTTAAGG-1	Pericyte
TGGTTGAGTCCGTAGG-1	Endothelial_cell
TGGTTGAGTCTAACCT-1	Cardiomyocyte
TGTAAAGCAAATTCGT-1	Endothelial_cell
TGTAAAGCATTGTGCA-1	Cardiomyocyte
TGTAACTCAATTAGGA-1	Cardiomyocyte
TGTAACTCAGGTTCAC-1	Endothelial_cell_1
TGTATCGCAGCAGGTA-1	Cardiomyocyte
TGTCATAAGTCATGCG-1	Cardiomyocyte
TGTCCTGGTAACTACG-1	Cardiomyocyte
TGTCCTTCAAATTCGT-1	Endothelial_cell
TGTGAAACATTGTCCT-1	Pericyte
TGTGATCAGGTAGCTT-1	Cardiomyocyte
TGTGCGGGTCATTACC-1	Cardiomyocyte
TGTGCTGAGATTGAGG-1	Cardiomyocyte
TGTGGCCAGGAACGGT-1	Cardiomyocyte
TGTGGCCAGGATTTGC-1	Cardiomyocyte
TGTGGCGGTGGAAACG-1	Endothelial_cell_1
TGTGGCTCAAGCCACT-1	Cardiomyocyte
TGTTACTTCAGCAAGA-1	Pericyte
TGTTGGCCAGCTTAGC-1	Cardiomyocyte
TGTTGTTTCTTAAGTG-1	Cardiomyocyte
TTAAAGGCAACTAGCC-1	Cardiomyocyte
TTAACTGAGAAGGTGC-1	Cardiomyocyte
TTAACTGAGCCTGAGC-1	Cardiomyocyte
TTAAGCCAGTTTCCTG-1	Cardiomyocyte
TTAAGTGTCATCCTAT-1	Cardiomyocyte
TTAAGTGTCGGTACGC-1	Immune_cell
TTAATCGAGAAAGGAA-1	Pericyte
TTAATCGAGCTCGCTT-1	Cardiomyocyte
TTAATCGAGTCAATCA-1	Endothelial_cell
TTACACCGTTTACCGT-1	Cardiomyocyte
TTACAGCAGTAGCGCC-1	Endothelial_cell
TTACCGTGTAAGCTTG-1	Endothelial_cell
TTACCTGTCAATCATG-1	Endothelial_cell
TTACGTTTCATAGCCG-1	Cardiomyocyte
TTACGTTTCCCGAAGC-1	Cardiomyocyte
TTAGAAGCACAATACT-1	Cardiomyocyte
TTAGCAGGTCTTACTA-1	Cardiomyocyte
TTAGCTGCAATAGCCC-1	Cardiomyocyte
TTAGCTGCATCGTTCT-1	Cardiomyocyte
TTAGGCTAGCTAAGTC-1	Cardiomyocyte
TTAGTCAAGATAAAGC-1	Cardiomyocyte
TTATAGCCAGTACCGT-1	Cardiomyocyte
TTATCCTAGGAGGCAT-1	Cardiomyocyte
TTATTGCTCTAAGTCA-1	Endothelial_cell
TTCAACCGTAACGAGG-1	Cardiomyocyte
TTCAGCACACTAGGTC-1	Cardiomyocyte
TTCAGCACATTGTGAT-1	Endothelial_cell_1
TTCAGTTTCATGCTAA-1	Cardiomyocyte
TTCATCCCAATTGAGA-1	Endothelial_cell_1
TTCATTCAGAACCTAC-1	Cardiomyocyte
TTCATTCAGGCCATCA-1	Cardiomyocyte
TTCCACGGTCAATACG-1	Endothelial_cell
TTCCACGGTTAGGTGC-1	Cardiomyocyte
TTCCTTGAGAACCTAC-1	Cardiomyocyte
TTCCTTGAGAGCCGCT-1	Endothelial_cell_1
TTCCTTGAGGTCCTGA-1	Cardiomyocyte
TTCGTTAGTTATGTGG-1	Cardiomyocyte
TTCTTAGGTGTGAGAG-1	Endothelial_cell_1
TTGACGTAGTGAGGTA-1	Cardiomyocyte
TTGACGTAGTTGTCAA-1	Endothelial_cell
TTGACTAAGGTAAGGC-1	Cardiomyocyte
TTGACTAAGGTGAAGC-1	Cardiomyocyte
TTGAGGCGTAGCTGGT-1	Cardiomyocyte
TTGAGGCGTAGTTGGC-1	Cardiomyocyte
TTGAGGCGTCGTAATG-1	Cardiomyocyte
TTGCAACAGCGTGCGT-1	Endothelial_cell
TTGCAAGGTTCACTGT-1	Cardiomyocyte
TTGCAGCCAGCAAATA-1	Cardiomyocyte
TTGCATTTCAAGCCTG-1	Cardiomyocyte
TTGCGAGTCAAACCGT-1	Cardiomyocyte
TTGCGAGTCCGTAAAC-1	Endothelial_cell
TTGGAGGCAAGCCACT-1	Endothelial_cell
TTGGATATCACATTGA-1	Cardiomyocyte
TTGGATCAGACACCGC-1	Cardiomyocyte
TTGGATCAGTACCGCA-1	Cardiomyocyte
TTGGATTCACCTATAG-1	Endothelial_cell
TTGGATTCATCCCTCA-1	Cardiomyocyte
TTGGCGGGTGGACCTG-1	Cardiomyocyte
TTGGCGGGTTCCTCCT-1	Cardiomyocyte
TTGGCTACAACTCGCG-1	Cardiomyocyte
TTGGCTACAATGAATG-1	Endothelial_cell
TTGGCTACATGGAGGC-1	Endothelial_cell
TTGGGCGGTCATGCCC-1	Cardiomyocyte
TTGTCAAAGCAACATC-1	Cardiomyocyte
TTGTCCGGTCCTTCAG-1	Cardiomyocyte
TTGTCCGGTGCCTCAC-1	Endothelial_cell
TTGTCCGGTTAGCTGA-1	Endothelial_cell
TTGTGAGGTGCGCGTA-1	Endothelial_cell_1
TTGTGCGAGCGGATAA-1	Cardiomyocyte
TTGTTGCGTACCGTTT-1	Cardiomyocyte
TTGTTGCGTGCGCAAT-1	Cardiomyocyte
TTTAACGAGCACCACA-1	Cardiomyocyte
TTTAAGCCAAGCCAGA-1	Cardiomyocyte
TTTACGAAGGTGAGAC-1	Cardiomyocyte
TTTACGAAGTTGTCTT-1	Endothelial_cell_1
TTTAGCAAGGAACCAA-1	Endothelial_cell
TTTAGCAAGTCGCTAG-1	Cardiomyocyte
TTTAGGATCTACTAAG-1	Cardiomyocyte
TTTCAGTTCAAAGGCA-1	Cardiomyocyte
TTTCATCAGGTCCAAT-1	Endothelial_cell
TTTCTTGCAAGCGATG-1	Cardiomyocyte
TTTGCATTCACAGACT-1	Endothelial_cell
TTTGCGACATAAGTCT-1	Endothelial_cell
TTTGCGACATCCTAGA-1	Cardiomyocyte
TTTGCGGAGGCATGTT-1	Cardiomyocyte
TTTGTCCCATAGCTTG-1	Cardiomyocyte
TTTGTGAAGCGAGCGA-1	Endothelial_cell
